កងអន្តរាគមន៍	កង|អន្តរាគមន៍	ក・ង・អ・ន・្・ត・រ・ា・គ・ម・ន・៍
កន្តរ៉	កន្តរ៉	ក・ន・្・ត・រ・៉
កន្តាញ	កន្តាញ	ក・ន・្・ត・ា・ញ
កន្តារ	កន្តារ	ក・ន・្・ត・ា・រ
កន្តារទ្ធា	កន្តារ|ទ្ធា	ក・ន・្・ត・ា・រ・ទ・្・ធ・ា
កន្តាវរ៉ាវ	កន្តាវ|រ៉ាវ	ក・ន・្・ត・ា・វ・រ・៉・ា・វ
កន្តាំង	កន្តាំង	ក・ន・្・ត・ា・ំ・ង
កន្តិញកន្តុញ	កន្តិញ|កន្តុញ	ក・ន・្・ត・ិ・ញ・ក・ន・្・ត・ុ・ញ
កន្តិញកន្តុញ	កន្តិញ|កន្តុញ	ក・ន・្・ត・ិ・ញ・ក・ន・្・ត・ុ・ញ
កន្តិល	កន្តិល	ក・ន・្・ត・ិ・ល
កន្តឹប	កន្តឹប	ក・ន・្・ត・ឹ・ប
កន្តឹម	កន្តឹម	ក・ន・្・ត・ឹ・ម
កន្តុញ	កន្តុញ	ក・ន・្・ត・ុ・ញ
កន្តុប	កន្តុប	ក・ន・្・ត・ុ・ប
កន្តុល	កន្តុល	ក・ន・្・ត・ុ・ល
កន្តុលឪ	កន្តុល|ឪ	ក・ន・្・ត・ុ・ល・ឪ
កន្តូ	កន្តូ	ក・ន・្・ត・ូ
កន្តូឡេត	កន្តូឡេត	ក・ន・្・ត・ូ・ឡ・េ・ត
កន្តើយ	កន្តើយ	ក・ន・្・ត・ើ・យ
កន្តេះឡង់	កន្តេះ|ឡង់	ក・ន・្・ត・េ・ះ・ឡ・ង・់
កន្តែរ៉ែ	កន្តែ|រ៉ែ	ក・ន・្・ត・ែ・រ・៉・ែ
កន្ត្រ	កន្ត្រ	ក・ន・្・ត・្・រ
កន្ត្រក	កន្ត្រក	ក・ន・្・ត・្・រ・ក
កន្ត្រង	កន្ត្រង	ក・ន・្・ត・្・រ・ង
កន្ត្រងប្រេង	កន្ត្រង|ប្រេង	ក・ន・្・ត・្・រ・ង・ប・្・រ・េ・ង
កន្ត្រប់	កន្ត្រប់	ក・ន・្・ត・្・រ・ប・់
កន្ត្រាក	កន្ត្រាក	ក・ន・្・ត・្・រ・ា・ក
កន្ត្រាក់	កន្ត្រាក់	ក・ន・្・ត・្・រ・ា・ក・់
កន្ត្រាក់សាច់ដុំ	កន្ត្រាក់|សាច់|ដុំ	ក・ន・្・ត・្・រ・ា・ក・់・ស・ា・ច・់・ដ・ុ・ំ
កន្ត្រើយ	កន្ត្រើយ	ក・ន・្・ត・្・រ・ើ・យ
កន្ត្រេកកន្ត្រាក	កន្ត្រេក|កន្ត្រាក	ក・ន・្・ត・្・រ・េ・ក・ក・ន・្・ត・្・រ・ា・ក
កន្ត្រេកកន្ត្រាក	កន្ត្រេក|កន្ត្រាក	ក・ន・្・ត・្・រ・េ・ក・ក・ន・្・ត・្・រ・ា・ក
កន្ត្រែង	កន្ត្រែង	ក・ន・្・ត・្・រ・ែ・ង
កន្ត្រៃ	កន្ត្រៃ	ក・ន・្・ត・្・រ・ៃ
កន្ត្រោង	កន្ត្រោង	ក・ន・្・ត・្・រ・ោ・ង
កន្ត្រោន	កន្ត្រោន	ក・ន・្・ត・្・រ・ោ・ន
កន្សែងយ័ន្ត	កន្សែង|យ័ន្ត	ក・ន・្・ស・ែ・ង・យ・័・ន・្・ត
កម្មន្ត	កម្មន្ត	ក・ម・្・ម・ន・្・ត
កម្មន្តរាយ	កម្មន្តរាយ	ក・ម・្・ម・ន・្・ត・រ・ា・យ
កម្មន្តសាល	កម្មន្ត|សាល	ក・ម・្・ម・ន・្・ត・ស・ា・ល
កម្លាំងវេទមន្ត	កម្លាំង|វេទមន្ត	ក・ម・្・ល・ា・ំ・ង・វ・េ・ទ・ម・ន・្・ត
កម្សាន្ត	កម្សាន្ត	ក・ម・្・ស・ា・ន・្・ត
ការន្ត	ការ|ន្ត	ក・ា・រ・ន・្・ត
ការបន្តពូជ	ការ|បន្ត|ពូជ	ក・ា・រ・ប・ន・្・ត・ព・ូ・ជ
ការបន្តពូជភេទ	ការ|បន្ត|ពូជ|ភេទ	ក・ា・រ・ប・ន・្・ត・ព・ូ・ជ・ភ・េ・ទ
ការបន្តពូជអភេទ	ការ|បន្ត|ពូជ|អភេទ	ក・ា・រ・ប・ន・្・ត・ព・ូ・ជ・អ・ភ・េ・ទ
កិច្ចព្រមព្រៀងសន្តិភាព	កិច្ច|ព្រមព្រៀង|សន្តិភាព	ក・ិ・ច・្・ច・ព・្・រ・ម・ព・្・រ・ៀ・ង・ស・ន・្・ត・ិ・ភ・ា・ព
កឹងកន្ត្រៃ	កឹង|កន្ត្រៃ	ក・ឹ・ង・ក・ន・្・ត・្・រ・ៃ
កុលវន្ត	កុល|វន្ត	ក・ុ・ល・វ・ន・្・ត
ក្សាន្ត	ក្សាន្ត	ក・្・ស・ា・ន・្・ត
ក្សេមក្សាន្ត	ក្សេមក្សាន្ត	ក・្・ស・េ・ម・ក・្・ស・ា・ន・្・ត
ខន្តី	ខន្តី	ខ・ន・្・ត・ី
ខន្តីបារមី	ខន្តី|បារមី	ខ・ន・្・ត・ី・ប・ា・រ・ម・ី
ខ្យល់កន្ត្រាក់	ខ្យល់|កន្ត្រាក់	ខ・្・យ・ល・់・ក・ន・្・ត・្・រ・ា・ក・់
ខ្សែភាពយន្ត	ខ្សែ|ភាពយន្ត	ខ・្・ស・ែ・ភ・ា・ព・យ・ន・្・ត
គជទន្ត	គជទន្ត	គ・ជ・ទ・ន・្・ត
គណនីចរន្ត	គណនី|ចរន្ត	គ・ណ・ន・ី・ច・រ・ន・្・ត
គណៈរដ្ឋមន្ត្រី	គណៈ|រដ្ឋ|មន្ត្រី	គ・ណ・ៈ・រ・ដ・្・ឋ・ម・ន・្・ត・្・រ・ី
គុណវន្ត	គុណ|វន្ត	គ・ុ・ណ・វ・ន・្・ត
គុណវន្តី	គុណ|វន្តី	គ・ុ・ណ・វ・ន・្・ត・ី
គោយន្ត	គោ|យន្ត	គ・ោ・យ・ន・្・ត
គ្រឿងយន្ត	គ្រឿង|យន្ត	គ・្・រ・ឿ・ង・យ・ន・្・ត
គ្រោះមហន្តរាយ	គ្រោះ|មហន្តរាយ	គ・្・រ・ោ・ះ・ម・ហ・ន・្・ត・រ・ា・យ
ចរន្ត	ចរន្ត	ច・រ・ន・្・ត
ចរន្តការ	ចរន្ត|ការ	ច・រ・ន・្・ត・ក・ា・រ
ចរន្តឆ្លាស់	ចរន្ត|ឆ្លាស់	ច・រ・ន・្・ត・ឆ・្・ល・ា・ស・់
ចរន្តជាប់	ចរន្ត|ជាប់	ច・រ・ន・្・ត・ជ・ា・ប・់
ចរន្តអគ្គិសនី	ចរន្ត|អគ្គិសនី	ច・រ・ន・្・ត・អ・គ・្・គ・ិ・ស・ន・ី
ចិន្តនាការ	ចិន្ត|នាការ	ច・ិ・ន・្・ត・ន・ា・ក・ា・រ
ចិន្តា	ចិន្តា	ច・ិ・ន・្・ត・ា
ចិន្តាមណី	ចិន្តាមណី	ច・ិ・ន・្・ត・ា・ម・ណ・ី
ចូឡាកន្តមង្គល	ចូឡា|កន្ត|មង្គល	ច・ូ・ឡ・ា・ក・ន・្・ត・ម・ង・្・គ・ល
ចូឡាក័ន្ត	ចូឡា|ក័ន្ត	ច・ូ・ឡ・ា・ក・័・ន・្・ត
ចោរកន្តារ	ចោរ|កន្តារ	ច・ោ・រ・ក・ន・្・ត・ា・រ
ចំណាយចរន្ត	ចំណាយ|ចរន្ត	ច・ំ・ណ・ា・យ・ច・រ・ន・្・ត
ចំណូលចរន្ត	ចំណូល|ចរន្ត	ច・ំ・ណ・ូ・ល・ច・រ・ន・្・ត
ឆទ្ទន្ត	ឆទ្ទន្ត	ឆ・ទ・្・ទ・ន・្・ត
ជណ្ដើរយន្ត	ជណ្ដើរ|យន្ត	ជ・ណ・្・ដ・ើ・រ・យ・ន・្・ត
ជនអនន្តោប្រវេសន៍	ជន|អនន្តោប្រវេសន៍	ជ・ន・អ・ន・ន・្・ត・ោ・ប・្・រ・វ・េ・ស・ន・៍
ជនអន្តោប្រវេសន៍	ជន|អន្តោប្រវេសន៍	ជ・ន・អ・ន・្・ត・ោ・ប・្・រ・វ・េ・ស・ន・៍
ជបមន្ត	ជបមន្ត	ជ・ប・ម・ន・្・ត
ជយមន្ត	ជយ|មន្ត	ជ・យ・ម・ន・្・ត
ជលយន្ត	ជល|យន្ត	ជ・ល・យ・ន・្・ត
ជវលេខយន្ត	ជវ|លេខ|យន្ត	ជ・វ・ល・េ・ខ・យ・ន・្・ត
ជីវន្ត	ជីវន្ត	ជ・ី・វ・ន・្・ត
ជីវន្តី	ជីវន្តី	ជ・ី・វ・ន・្・ត・ី
ជីវិតន្តរាយ	ជីវិត|ន្តរាយ	ជ・ី・វ・ិ・ត・ន・្・ត・រ・ា・យ
ជុតិមន្ត	ជុតិមន្ត	ជ・ុ・ត・ិ・ម・ន・្・ត
ជុតិមន្តី	ជុតិមន្តី	ជ・ុ・ត・ិ・ម・ន・្・ត・ី
ជេដ្ឋាមន្ត្រី	ជេដ្ឋា|មន្ត្រី	ជ・េ・ដ・្・ឋ・ា・ម・ន・្・ត・្・រ・ី
ញាតិសន្តាន	ញាតិ|សន្តាន	ញ・ា・ត・ិ・ស・ន・្・ត・ា・ន
ដួងជីវន្ត	ដួង|ជីវន្ត	ដ・ួ・ង・ជ・ី・វ・ន・្・ត
ឋានន្តរ	ឋានន្តរ	ឋ・ា・ន・ន・្・ត・រ
ឋានន្តរនាម	ឋានន្តរ|នាម	ឋ・ា・ន・ន・្・ត・រ・ន・ា・ម
ឋានន្តរភូមិ	ឋានន្តរ|ភូមិ	ឋ・ា・ន・ន・្・ត・រ・ភ・ូ・ម・ិ
ឋានន្តរសក្ដិ	ឋានន្តរ|សក្ដិ	ឋ・ា・ន・ន・្・ត・រ・ស・ក・្・ដ・ិ
តន្តិភាសា	តន្តិភាសា	ត・ន・្・ត・ិ・ភ・ា・ស・ា
តន្តី	តន្តី	ត・ន・្・ត・ី
តន្ត្រី	តន្ត្រី	ត・ន・្・ត・្・រ・ី
តន្ត្រីករ	តន្ត្រី|ករ	ត・ន・្・ត・្・រ・ី・ក・រ
តន្ត្រីការិនី	តន្ត្រី|ការិនី	ត・ន・្・ត・្・រ・ី・ក・ា・រ・ិ・ន・ី
តន្ត្រំ	តន្ត្រំ	ត・ន・្・ត・្・រ・ំ
តុលាការយុត្តិធម៌អន្តរជាតិ	តុលាការ|យុត្តិធម៌|អន្តរ|ជាតិ	ត・ុ・ល・ា・ក・ា・រ・យ・ុ・ត・្・ត・ិ・ធ・ម・៌・អ・ន・្・ត・រ・ជ・ា・ត・ិ
តូយ៌តន្ត្រី	តូយ៌|តន្ត្រី	ត・ូ・យ・៌・ត・ន・្・ត・្・រ・ី
តូរ្យតន្ត្រី	តូរ្យ|តន្ត្រី	ត・ូ・រ・្・យ・ត・ន・្・ត・្・រ・ី
តេជវន្ត	តេជ|វន្ត	ត・េ・ជ・វ・ន・្・ត
តេជវន្តី	តេជ|វន្តី	ត・េ・ជ・វ・ន・្・ត・ី
ត្រស្តិសង្ក្រាន្ត	ត្រស្តិ|សង្ក្រាន្ត	ត・្・រ・ស・្・ត・ិ・ស・ង・្・ក・្・រ・ា・ន・្・ត
ត្រីចក្រយានយន្ត	ត្រី|ចក្រ|យាន|យន្ត	ត・្・រ・ី・ច・ក・្・រ・យ・ា・ន・យ・ន・្・ត
ត្រុកៗអ្នកស្រុកមើលងាយ រលាស់គូទខ្ចាយមានឱតមានភ័ន្ត	ត្រុក|ៗ|អ្នក|ស្រុក|មើលងាយ| |រលាស់|គូទ|ខ្ចាយ|មាន|ឱត|មាន|ភ័ន្ត	ត・្・រ・ុ・ក・ៗ・អ・្・ន・ក・ស・្・រ・ុ・ក・ម・ើ・ល・ង・ា・យ・ ・រ・ល・ា・ស・់・គ・ូ・ទ・ខ・្・ច・ា・យ・ម・ា・ន・ឱ・ត・ម・ា・ន・ភ・័・ន・្・ត
ថាមវន្ត	ថាមវន្ត	ថ・ា・ម・វ・ន・្・ត
ថ្នាំបន្តក់	ថ្នាំ|បន្តក់	ថ・្・ន・ា・ំ・ប・ន・្・ត・ក・់
ទងកន្ត្រៃ	ទង|កន្ត្រៃ	ទ・ង・ក・ន・្・ត・្・រ・ៃ
ទន្ត	ទន្ត	ទ・ន・្・ត
ទន្តកម្ម	ទន្ត|កម្ម	ទ・ន・្・ត・ក・ម・្・ម
ទន្តការ	ទន្ត|ការ	ទ・ន・្・ត・ក・ា・រ
ទន្តការី	ទន្ត|ការី	ទ・ន・្・ត・ក・ា・រ・ី
ទន្តជ	ទន្ត|ជ	ទ・ន・្・ត・ជ
ទន្តជៈ	ទន្តជៈ	ទ・ន・្・ត・ជ・ៈ
ទន្តធាតុ	ទន្ត|ធាតុ	ទ・ន・្・ត・ធ・ា・ត・ុ
ទន្តបណ្ឌិត	ទន្ត|បណ្ឌិត	ទ・ន・្・ត・ប・ណ・្・ឌ・ិ・ត
ទន្តពេទ្យ	ទន្ត|ពេទ្យ	ទ・ន・្・ត・ព・េ・ទ・្・យ
ទន្តម័យ	ទន្ត|ម័យ	ទ・ន・្・ត・ម・័・យ
ទន្តវិក័តិ	ទន្ត|វិក័តិ	ទ・ន・្・ត・វ・ិ・ក・័・ត・ិ
ទន្តវេជ្ជសាស្ត្រ	ទន្ត|វេជ្ជ|សាស្ត្រ	ទ・ន・្・ត・វ・េ・ជ・្・ជ・ស・ា・ស・្・ត・្・រ
ទន្តសោធនី	ទន្ត|សោធនី	ទ・ន・្・ត・ស・ោ・ធ・ន・ី
ទន្តា	ទន្តា	ទ・ន・្・ត・ា
ទន្តោដ្ឋជៈ	ទន្តោដ្ឋ|ជៈ	ទ・ន・្・ត・ោ・ដ・្・ឋ・ជ・ៈ
ទន្ត្រំ	ទន្ត្រំ	ទ・ន・្・ត・្・រ・ំ
ទិព្វមន្ត	ទិព្វ|មន្ត	ទ・ិ・ព・្・វ・ម・ន・្・ត
ទិវាកុមារអន្តរជាតិ	ទិវា|កុមារ|អន្តរ|ជាតិ	ទ・ិ・វ・ា・ក・ុ・ម・ា・រ・អ・ន・្・ត・រ・ជ・ា・ត・ិ
ទិវាពលកម្មអន្តរជាតិ	ទិវា|ពលកម្ម|អន្តរ|ជាតិ	ទ・ិ・វ・ា・ព・ល・ក・ម・្・ម・អ・ន・្・ត・រ・ជ・ា・ត・ិ
ទិវាសិទ្ធិនារីអន្តរជាតិ	ទិវា|សិទ្ធិ|នារី|អន្តរ|ជាតិ	ទ・ិ・វ・ា・ស・ិ・ទ・្・ធ・ិ・ន・ា・រ・ី・អ・ន・្・ត・រ・ជ・ា・ត・ិ
ទិវាសិទ្ធិមនុស្សអន្តរជាតិ	ទិវា|សិទ្ធិ|មនុស្ស|អន្តរ|ជាតិ	ទ・ិ・វ・ា・ស・ិ・ទ・្・ធ・ិ・ម・ន・ុ・ស・្・ស・អ・ន・្・ត・រ・ជ・ា・ត・ិ
ទីស្ដីការគណៈរដ្ឋមន្ត្រី	ទីស្ដីការ|គណៈ|រដ្ឋ|មន្ត្រី	ទ・ី・ស・្・ដ・ី・ក・ា・រ・គ・ណ・ៈ・រ・ដ・្・ឋ・ម・ន・្・ត・្・រ・ី
ទឹកមន្ត	ទឹក|មន្ត	ទ・ឹ・ក・ម・ន・្・ត
ទុព្ភិក្ខកន្តារ	ទុព្ភិក្ខ|កន្តារ	ទ・ុ・ព・្・ភ・ិ・ក・្・ខ・ក・ន・្・ត・ា・រ
ទេពនិមន្ត	ទេព|និមន្ត	ទ・េ・ព・ន・ិ・ម・ន・្・ត
ទេពនិមន្តន៍	ទេព|និមន្តន៍	ទ・េ・ព・ន・ិ・ម・ន・្・ត・ន・៍
ទេសន្តរប្រវេសករ	ទេសន្តរប្រវេសករ	ទ・េ・ស・ន・្・ត・រ・ប・្・រ・វ・េ・ស・ក・រ
ទេសន្តរប្រវេសន៍	ទេសន្តរប្រវេសន៍	ទ・េ・ស・ន・្・ត・រ・ប・្・រ・វ・េ・ស・ន・៍
ទោចក្រយានយន្ត	ទោ|ចក្រ|យាន|យន្ត	ទ・ោ・ច・ក・្・រ・យ・ា・ន・យ・ន・្・ត
ទ្រព្យសកម្មចរន្ត	ទ្រព្យ|សកម្ម|ចរន្ត	ទ・្・រ・ព・្・យ・ស・ក・ម・្・ម・ច・រ・ន・្・ត
ទ្វិទន្ត	ទ្វិទន្ត	ទ・្・វ・ិ・ទ・ន・្・ត
ធម្មន្តេវាសិក	ធម្មន្តេវាសិក	ធ・ម・្・ម・ន・្・ត・េ・វ・ា・ស・ិ・ក
ធាតុអន្តរធាន	ធាតុ|អន្តរធាន	ធ・ា・ត・ុ・អ・ន・្・ត・រ・ធ・ា・ន
នព្វន្ត	នព្វន្ត	ន・ព・្・វ・ន・្・ត
នាគទន្ត	នាគ|ទន្ត	ន・ា・គ・ទ・ន・្・ត
នាវាផ្ទុកយន្តហោះ	នាវា|ផ្ទុក|យន្ត|ហោះ	ន・ា・វ・ា・ផ・្・ទ・ុ・ក・យ・ន・្・ត・ហ・ោ・ះ
និមន្ត	និមន្ត	ន・ិ・ម・ន・្・ត
និមន្តន៍	និមន្តន៍	ន・ិ・ម・ន・្・ត・ន・៍
និរន្តរ	និរន្តរ	ន・ិ・រ・ន・្・ត・រ
និរន្តរភាព	និរន្តរ|ភាព	ន・ិ・រ・ន・្・ត・រ・ភ・ា・ព
និរន្តរាយ	និរន្តរាយ	ន・ិ・រ・ន・្・ត・រ・ា・យ
និរន្តរ៍	និរន្តរ៍	ន・ិ・រ・ន・្・ត・រ・៍
និរុទកកន្តារ	និរុទក|កន្តារ	ន・ិ・រ・ុ・ទ・ក・ក・ន・្・ត・ា・រ
និស្សយន្តេវាសិក	និស្ស|យន្តេវាសិក	ន・ិ・ស・្・ស・យ・ន・្・ត・េ・វ・ា・ស・ិ・ក
បច្ចន្តគ្រាម	បច្ចន្ត|គ្រាម	ប・ច・្・ច・ន・្・ត・គ・្・រ・ា・ម
បច្ចន្តជនបទ	បច្ចន្ត|ជនបទ	ប・ច・្・ច・ន・្・ត・ជ・ន・ប・ទ
បច្ចន្តប្រទេស	បច្ចន្ត|ប្រទេស	ប・ច・្・ច・ន・្・ត・ប・្・រ・ទ・េ・ស
បញ្ញវន្ត	បញ្ញវន្ត	ប・ញ・្・ញ・វ・ន・្・ត
បញ្ញវន្តី	បញ្ញវន្តី	ប・ញ・្・ញ・វ・ន・្・ត・ី
បទអន្តរាគមន៍	បទ|អន្តរាគមន៍	ប・ទ・អ・ន・្・ត・រ・ា・គ・ម・ន・៍
បន្ត	បន្ត	ប・ន・្・ត
បន្តកន្ទុយ	បន្ត|កន្ទុយ	ប・ន・្・ត・ក・ន・្・ទ・ុ・យ
បន្តក់	បន្តក់	ប・ន・្・ត・ក・់
បន្តបន្ទាប់	បន្ត|បន្ទាប់	ប・ន・្・ត・ប・ន・្・ទ・ា・ប・់
បន្តពូជ	បន្ត|ពូជ	ប・ន・្・ត・ព・ូ・ជ
បន្តពូជភេទ	បន្ត|ពូជ|ភេទ	ប・ន・្・ត・ព・ូ・ជ・ភ・េ・ទ
បន្តពូជអភេទ	បន្ត|ពូជ|អភេទ	ប・ន・្・ត・ព・ូ・ជ・អ・ភ・េ・ទ
បន្តម	បន្ត|ម	ប・ន・្・ត・ម
បន្តិច	បន្តិច	ប・ន・្・ត・ិ・ច
បន្តិចបន្តួច	បន្តិចបន្តួច	ប・ន・្・ត・ិ・ច・ប・ន・្・ត・ួ・ច
បន្តិចបន្តួច	បន្តិចបន្តួច	ប・ន・្・ត・ិ・ច・ប・ន・្・ត・ួ・ច
បន្តឹង	បន្តឹង	ប・ន・្・ត・ឹ・ង
បន្តុប	បន្តុប	ប・ន・្・ត・ុ・ប
បន្តុះ	បន្តុះ	ប・ន・្・ត・ុ・ះ
បន្តុះបង្អាប់	បន្តុះ|បង្អាប់	ប・ន・្・ត・ុ・ះ・ប・ង・្・អ・ា・ប・់
បន្តូច	បន្តូច	ប・ន・្・ត・ូ・ច
បន្តូចបន្ទាប	បន្តូច|បន្ទាប	ប・ន・្・ត・ូ・ច・ប・ន・្・ទ・ា・ប
បន្តួច	បន្តួច	ប・ន・្・ត・ួ・ច
បន្តើត	បន្តើត	ប・ន・្・ត・ើ・ត
បន្តោក	បន្តោក	ប・ន・្・ត・ោ・ក
បន្តោង	បន្តោង	ប・ន・្・ត・ោ・ង
បព្វជ្ជន្តេវាសិក	បព្វជ្ជន្តេវាសិក	ប・ព・្・វ・ជ・្・ជ・ន・្・ត・េ・វ・ា・ស・ិ・ក
បុញ្ញវន្ត	បុញ្ញវន្ត	ប・ុ・ញ・្・ញ・វ・ន・្・ត
បុញ្ញវន្តី	បុញ្ញវន្តី	ប・ុ・ញ・្・ញ・វ・ន・្・ត・ី
បើករថយន្ត	បើក|រថ|យន្ត	ប・ើ・ក・រ・ថ・យ・ន・្・ត
បំភ័ន្ត	បំភ័ន្ត	ប・ំ・ភ・័・ន・្・ត
ប៉ុន្តែ	ប៉ុន្តែ	ប・៉・ុ・ន・្・ត・ែ
ប្រេមវន្ត	ប្រេម|វន្ត	ប・្・រ・េ・ម・វ・ន・្・ត
ពន្ធុមន្ត	ពន្ធុ|មន្ត	ព・ន・្・ធ・ុ・ម・ន・្・ត
ពលករទេសន្តរប្រវេសន៍	ពលករ|ទេសន្តរប្រវេសន៍	ព・ល・ក・រ・ទ・េ・ស・ន・្・ត・រ・ប・្・រ・វ・េ・ស・ន・៍
ពហុមន្តិនី	ពហុ|មន្តិនី	ព・ហ・ុ・ម・ន・្・ត・ិ・ន・ី
ពហុមន្តី	ពហុ|មន្តី	ព・ហ・ុ・ម・ន・្・ត・ី
ពិព័រណ៍អន្តរជាតិ	ពិព័រណ៍|អន្តរ|ជាតិ	ព・ិ・ព・័・រ・ណ・៍・អ・ន・្・ត・រ・ជ・ា・ត・ិ
ពិសាលសន្តាន	ពិសាល|សន្តាន	ព・ិ・ស・ា・ល・ស・ន・្・ត・ា・ន
ពុទ្ធន្តរ	ពុទ្ធ|ន្តរ	ព・ុ・ទ・្・ធ・ន・្・ត・រ
ពុទ្ធមន្ត	ពុទ្ធ|មន្ត	ព・ុ・ទ・្・ធ・ម・ន・្・ត
ពេជយ័ន្ត	ពេជយ័ន្ត	ព・េ・ជ・យ・័・ន・្・ត
ព្រងើយកន្តើយ	ព្រងើយ|កន្តើយ	ព・្・រ・ង・ើ・យ・ក・ន・្・ត・ើ・យ
ព្រលានយន្តហោះ	ព្រលាន|យន្ត|ហោះ	ព・្・រ・ល・ា・ន・យ・ន・្・ត・ហ・ោ・ះ
ព្រហក់កន្តរ៉	ព្រហក់|កន្តរ៉	ព・្・រ・ហ・ក・់・ក・ន・្・ត・រ・៉
ភគវន្ត	ភគវន្ត	ភ・គ・វ・ន・្・ត
ភគវន្តមុនី	ភគវន្ត|មុនី	ភ・គ・វ・ន・្・ត・ម・ុ・ន・ី
ភគវ័ន្ត	ភគវ័ន្ត	ភ・គ・វ・័・ន・្・ត
ភតិសន្យាបន្ត	ភតិសន្យា|បន្ត	ភ・ត・ិ・ស・ន・្・យ・ា・ប・ន・្・ត
ភទន្ត	ភទន្ត	ភ・ទ・ន・្・ត
ភទន្តេ!	ភទន្តេ|!	ភ・ទ・ន・្・ត・េ・!
ភទន្តៈ	ភទន្តៈ	ភ・ទ・ន・្・ត・ៈ
ភប់ភ័ន្ត	ភប់|ភ័ន្ត	ភ・ប・់・ភ・័・ន・្・ត
ភយន្តរាយ	ភយន្តរាយ	ភ・យ・ន・្・ត・រ・ា・យ
ភាពយន្ត	ភាពយន្ត	ភ・ា・ព・យ・ន・្・ត
ភាពយន្តគ	ភាពយន្ត|គ	ភ・ា・ព・យ・ន・្・ត・គ
ភោគវន្តី	ភោគ|វន្តី	ភ・ោ・គ・វ・ន・្・ត・ី
ភោគវ័ន្ត	ភោគ|វ័ន្ត	ភ・ោ・គ・វ・័・ន・្・ត
ភ័ន្ត	ភ័ន្ត	ភ・័・ន・្・ត
មការន្ត	មការ|ន្ត	ម・ក・ា・រ・ន・្・ត
មជ្ឈន្តិក	មជ្ឈន្តិក	ម・ជ・្・ឈ・ន・្・ត・ិ・ក
មជ្ឈន្តិកកាល	មជ្ឈន្តិក|កាល	ម・ជ・្・ឈ・ន・្・ត・ិ・ក・ក・ា・ល
មជ្ឈន្តិកនិយម	មជ្ឈន្តិក|និយម	ម・ជ・្・ឈ・ន・្・ត・ិ・ក・ន・ិ・យ・ម
មជ្ឈន្តិកភាព	មជ្ឈន្តិក|ភាព	ម・ជ・្・ឈ・ន・្・ត・ិ・ក・ភ・ា・ព
មជ្ឈន្តិការិនី	មជ្ឈន្តិការិនី	ម・ជ・្・ឈ・ន・្・ត・ិ・ក・ា・រ・ិ・ន・ី
មជ្ឈន្តិការី	មជ្ឈន្តិការី	ម・ជ・្・ឈ・ន・្・ត・ិ・ក・ា・រ・ី
មជ្ឈន្តិកិរិនី	មជ្ឈន្តិកិរិនី	ម・ជ・្・ឈ・ន・្・ត・ិ・ក・ិ・រ・ិ・ន・ី
មជ្ឈន្តិកី	មជ្ឈន្តិកី	ម・ជ・្・ឈ・ន・្・ត・ិ・ក・ី
មជ្ឈន្តិកៈ	មជ្ឈន្តិកៈ	ម・ជ・្・ឈ・ន・្・ត・ិ・ក・ៈ
មតិមន្ត	មតិ|មន្ត	ម・ត・ិ・ម・ន・្・ត
មតិមន្តី	មតិ|មន្តី	ម・ត・ិ・ម・ន・្・ត・ី
មនុស្សយន្ត	មនុស្ស|យន្ត	ម・ន・ុ・ស・្・ស・យ・ន・្・ត
មន្ត	មន្ត	ម・ន・្・ត
មន្តី	មន្តី	ម・ន・្・ត・ី
មន្ត្រ	មន្ត្រ	ម・ន・្・ត・្・រ
មន្ត្រវិត	មន្ត្រ|វិត	ម・ន・្・ត・្・រ・វ・ិ・ត
មន្ត្រី	មន្ត្រី	ម・ន・្・ត・្・រ・ី
មន្ត្រីកិត្តិយស	មន្ត្រី|កិត្តិ|យស	ម・ន・្・ត・្・រ・ី・ក・ិ・ត・្・ត・ិ・យ・ស
មន្ត្រីខែត្រ	មន្ត្រី|ខែ|ត្រ	ម・ន・្・ត・្・រ・ី・ខ・ែ・ត・្・រ
មន្ត្រីខ្មោច	មន្ត្រី|ខ្មោច	ម・ន・្・ត・្・រ・ី・ខ・្・ម・ោ・ច
មន្ត្រីឃុំ	មន្ត្រី|ឃុំ	ម・ន・្・ត・្・រ・ី・ឃ・ុ・ំ
មន្ត្រីសង្កាត់	មន្ត្រី|សង្កាត់	ម・ន・្・ត・្・រ・ី・ស・ង・្・ក・ា・ត・់
មន្ត្រីសន្និបាត	មន្ត្រី|សន្និបាត	ម・ន・្・ត・្・រ・ី・ស・ន・្・ន・ិ・ប・ា・ត
មន្ត្រីសភា	មន្ត្រី|សភា	ម・ន・្・ត・្・រ・ី・ស・ភ・ា
មន្ត្រីសម្រាប់ឯក	មន្ត្រី|សម្រាប់|ឯក	ម・ន・្・ត・្・រ・ី・ស・ម・្・រ・ា・ប・់・ឯ・ក
មន្ទីរសន្តិសុខ	មន្ទីរ|សន្តិសុខ	ម・ន・្・ទ・ី・រ・ស・ន・្・ត・ិ・ស・ុ・ខ
មរុកន្តារ	មរុកន្តារ	ម・រ・ុ・ក・ន・្・ត・ា・រ
មហន្ត	មហន្ត	ម・ហ・ន・្・ត
មហន្តគុណ	មហន្ត|គុណ	ម・ហ・ន・្・ត・គ・ុ・ណ
មហន្តទោស	មហន្ត|ទោស	ម・ហ・ន・្・ត・ទ・ោ・ស
មហន្តរាយ	មហន្តរាយ	ម・ហ・ន・្・ត・រ・ា・យ
មហន្តាប័ណ	មហន្តាប័ណ	ម・ហ・ន・្・ត・ា・ប・័・ណ
មហាមន្ត្រី	មហា|មន្ត្រី	ម・ហ・ា・ម・ន・្・ត・្・រ・ី
មហាសង្ក្រាន្ត	មហា|សង្ក្រាន្ត	ម・ហ・ា・ស・ង・្・ក・្・រ・ា・ន・្・ត
មហិមន្ត	មហិមន្ត	ម・ហ・ិ・ម・ន・្・ត
មានឱតមានភ័ន្ត	មាន|ឱត|មាន|ភ័ន្ត	ម・ា・ន・ឱ・ត・ម・ា・ន・ភ・័・ន・្・ត
មិច្ឆាកម្មន្តៈ	មិច្ឆា|កម្មន្តៈ	ម・ិ・ច・្・ឆ・ា・ក・ម・្・ម・ន・្・ត・ៈ
មុខមន្ត្រី	មុខ|មន្ត្រី	ម・ុ・ខ・ម・ន・្・ត・្・រ・ី
មូសិកទន្ត	មូសិក|ទន្ត	ម・ូ・ស・ិ・ក・ទ・ន・្・ត
មេនព្វន្ត	មេន|ព្វន្ត	ម・េ・ន・ព・្・វ・ន・្・ត
យន្ត	យន្ត	យ・ន・្・ត
យន្តកម្ម	យន្ត|កម្ម	យ・ន・្・ត・ក・ម・្・ម
យន្តការ	យន្តការ	យ・ន・្・ត・ក・ា・រ
យន្តការី	យន្តការី	យ・ន・្・ត・ក・ា・រ・ី
យន្តបថ	យន្តបថ	យ・ន・្・ត・ប・ថ
យន្តវិជ្ជា	យន្ត|វិជ្ជា	យ・ន・្・ត・វ・ិ・ជ・្・ជ・ា
យន្តសាល	យន្ត|សាល	យ・ន・្・ត・ស・ា・ល
យន្តសាលា	យន្ត|សាលា	យ・ន・្・ត・ស・ា・ល・ា
យន្តសិក្សា	យន្ត|សិក្សា	យ・ន・្・ត・ស・ិ・ក・្・ស・ា
យន្តហោះ	យន្ត|ហោះ	យ・ន・្・ត・ហ・ោ・ះ
យន្តហោះទឹក	យន្ត|ហោះ|ទឹក	យ・ន・្・ត・ហ・ោ・ះ・ទ・ឹ・ក
យន្តហោះប្រដេញ	យន្ត|ហោះ|ប្រដេញ	យ・ន・្・ត・ហ・ោ・ះ・ប・្・រ・ដ・េ・ញ
យន្តហោះលឿនជាងសំឡេង	យន្ត|ហោះ|លឿន|ជាង|សំឡេង	យ・ន・្・ត・ហ・ោ・ះ・ល・ឿ・ន・ជ・ា・ង・ស・ំ・ឡ・េ・ង
យន្តូបនីយកម្ម	យន្តូបនីយ|កម្ម	យ・ន・្・ត・ូ・ប・ន・ី・យ・ក・ម・្・ម
យន្ត្រ	យន្ត្រ	យ・ន・្・ត・្・រ
យន្ត្រវិទ្យា	យន្ត្រ|វិទ្យា	យ・ន・្・ត・្・រ・វ・ិ・ទ・្・យ・ា
យន្ត្រសាស្ត្រ	យន្ត្រ|សាស្ត្រ	យ・ន・្・ត・្・រ・ស・ា・ស・្・ត・្・រ
យន្ត្រសិក្សា	យន្ត្រ|សិក្សា	យ・ន・្・ត・្・រ・ស・ិ・ក・្・ស・ា
យសវន្ត	យសវន្ត	យ・ស・វ・ន・្・ត
យានយន្ត	យាន|យន្ត	យ・ា・ន・យ・ន・្・ត
យានយន្តូបករណ៍	យាន|យន្តូបករណ៍	យ・ា・ន・យ・ន・្・ត・ូ・ប・ក・រ・ណ・៍
យុគន្តកាល	យុគន្តកាល	យ・ុ・គ・ន・្・ត・ក・ា・ល
យុត្តចិន្តា	យុត្ត|ចិន្តា	យ・ុ・ត・្・ត・ច・ិ・ន・្・ត・ា
យុទ្ធសន្តិភាព	យុទ្ធ|សន្តិភាព	យ・ុ・ទ・្・ធ・ស・ន・្・ត・ិ・ភ・ា・ព
យ័ន្ត	យ័ន្ត	យ・័・ន・្・ត
យ័ន្ត្រ	យ័ន្ត្រ	យ・័・ន・្・ត・្・រ
រកស៊ីមួយឆ្នាំកើនបន្តិច	រក|ស៊ី|មួយ|ឆ្នាំ|កើន|បន្តិច	រ・ក・ស・៊・ី・ម・ួ・យ・ឆ・្・ន・ា・ំ・ក・ើ・ន・ប・ន・្・ត・ិ・ច
រជ្ជន្តរកាល	រជ្ជន្តរ|កាល	រ・ជ・្・ជ・ន・្・ត・រ・ក・ា・ល
រដ្ឋប្រសាន្តិភាព	រដ្ឋ|ប្រសាន្តិភាព	រ・ដ・្・ឋ・ប・្・រ・ស・ា・ន・្・ត・ិ・ភ・ា・ព
រដ្ឋមន្ត្រី	រដ្ឋ|មន្ត្រី	រ・ដ・្・ឋ・ម・ន・្・ត・្・រ・ី
រដ្ឋមន្ត្រីគណៈ	រដ្ឋ|មន្ត្រី|គណៈ	រ・ដ・្・ឋ・ម・ន・្・ត・្・រ・ី・គ・ណ・ៈ
រដ្ឋសន្តិភាព	រដ្ឋ|សន្តិភាព	រ・ដ・្・ឋ・ស・ន・្・ត・ិ・ភ・ា・ព
រណមន្ត្រី	រណ|មន្ត្រី	រ・ណ・ម・ន・្・ត・្・រ・ី
រណសាន្តិភាព	រណ|សាន្តិភាព	រ・ណ・ស・ា・ន・្・ត・ិ・ភ・ា・ព
រថបន្តោង	រថ|បន្តោង	រ・ថ・ប・ន・្・ត・ោ・ង
រថយន្ត	រថ|យន្ត	រ・ថ・យ・ន・្・ត
រថយន្តក្រុង	រថ|យន្ត|ក្រុង	រ・ថ・យ・ន・្・ត・ក・្・រ・ុ・ង
រថយន្តគ្រួសារ	រថ|យន្ត|គ្រួសារ	រ・ថ・យ・ន・្・ត・គ・្・រ・ួ・ស・ា・រ
រថយន្ត្រ	រថ|យន្ត្រ	រ・ថ・យ・ន・្・ត・្・រ
រន្តិភាព	រន្តិភាព	រ・ន・្・ត・ិ・ភ・ា・ព
របបសន្តិសុខសង្គម	របប|សន្តិសុខ|សង្គម	រ・ប・ប・ស・ន・្・ត・ិ・ស・ុ・ខ・ស・ង・្・គ・ម
រវៃរថយន្ត	រវៃ|រថ|យន្ត	រ・វ・ៃ・រ・ថ・យ・ន・្・ត
រហស្សចិន្តា	រហស្ស|ចិន្តា	រ・ហ・ស・្・ស・ច・ិ・ន・្・ត・ា
រហស្សមន្តិនី	រហស្ស|មន្តិនី	រ・ហ・ស・្・ស・ម・ន・្・ត・ិ・ន・ី
រហស្សមន្តី	រហស្ស|មន្តី	រ・ហ・ស・្・ស・ម・ន・្・ត・ី
រាជនិមន្តន៍	រាជ|និមន្តន៍	រ・ា・ជ・ន・ិ・ម・ន・្・ត・ន・៍
រាជមន្ត	រាជ|មន្ត	រ・ា・ជ・ម・ន・្・ត
រាជមន្ត្រ	រាជ|មន្ត្រ	រ・ា・ជ・ម・ន・្・ត・្・រ
រាជមន្ត្រី	រាជ|មន្ត្រី	រ・ា・ជ・ម・ន・្・ត・្・រ・ី
រាយមន្ត	រាយ|មន្ត	រ・ា・យ・ម・ន・្・ត
រូបមន្ត	រូបមន្ត	រ・ូ・ប・ម・ន・្・ត
រូបមន្តគីមី	រូបមន្ត|គីមី	រ・ូ・ប・ម・ន・្・ត・គ・ី・ម・ី
រូបវន្ត	រូប|វន្ត	រ・ូ・ប・វ・ន・្・ត
រូបវន្តបុគ្គល	រូប|វន្ត|បុគ្គល	រ・ូ・ប・វ・ន・្・ត・ប・ុ・គ・្・គ・ល
រោគសាន្ត	រោគ|សាន្ត	រ・ោ・គ・ស・ា・ន・្・ត
រោគសាន្តិភាព	រោគ|សាន្តិភាព	រ・ោ・គ・ស・ា・ន・្・ត・ិ・ភ・ា・ព
លក្ខណមន្ត	លក្ខណ|មន្ត	ល・ក・្・ខ・ណ・ម・ន・្・ត
លក្ខន្តិក	លក្ខន្តិក	ល・ក・្・ខ・ន・្・ត・ិ・ក
លក្ខន្តិកប្បញ្ញត្តិ	លក្ខន្តិកប្បញ្ញត្តិ	ល・ក・្・ខ・ន・្・ត・ិ・ក・ប・្・ប・ញ・្・ញ・ត・្・ត・ិ
លក្ខន្តិកសញ្ញា	លក្ខន្តិក|សញ្ញា	ល・ក・្・ខ・ន・្・ត・ិ・ក・ស・ញ・្・ញ・ា
លក្ខន្តិកៈ	លក្ខន្តិកៈ	ល・ក・្・ខ・ន・្・ត・ិ・ក・ៈ
លឃុចិន្តា	លឃុចិន្តា	ល・ឃ・ុ・ច・ិ・ន・្・ត・ា
លន្តែ	លន្តែ	ល・ន・្・ត・ែ
លហុចិន្តា	លហុចិន្តា	ល・ហ・ុ・ច・ិ・ន・្・ត・ា
លាភន្តរាយ	លាភ|ន្តរាយ	ល・ា・ភ・ន・្・ត・រ・ា・យ
លាភសន្តោស	លាភ|សន្តោស	ល・ា・ភ・ស・ន・្・ត・ោ・ស
លេខនព្វន្ត	លេខ|នព្វន្ត	ល・េ・ខ・ន・ព・្・វ・ន・្・ត
លេខយ័ន្ត	លេខ|យ័ន្ត	ល・េ・ខ・យ・័・ន・្・ត
លោកចិន្តា	លោក|ចិន្តា	ល・ោ・ក・ច・ិ・ន・្・ត・ា
លោកន្តគូ	លោក|ន្ត|គូ	ល・ោ・ក・ន・្・ត・គ・ូ
លោកន្តទស្សី	លោក|ន្ត|ទស្សី	ល・ោ・ក・ន・្・ត・ទ・ស・្・ស・ី
លោកន្តរ	លោក|ន្តរ	ល・ោ・ក・ន・្・ត・រ
លោកន្តរនរក	លោក|ន្តរ|នរក	ល・ោ・ក・ន・្・ត・រ・ន・រ・ក
លោកន្តរិកសត្វ	លោក|ន្ត|រិក|សត្វ	ល・ោ・ក・ន・្・ត・រ・ិ・ក・ស・ត・្・វ
លោកសន្តិភាព	លោក|សន្តិភាព	ល・ោ・ក・ស・ន・្・ត・ិ・ភ・ា・ព
លោកសន្តិសុខ	លោក|សន្តិសុខ	ល・ោ・ក・ស・ន・្・ត・ិ・ស・ុ・ខ
លោហកាន្ត	លោហ|កាន្ត	ល・ោ・ហ・ក・ា・ន・្・ត
វគ្គន្តៈ	វគ្គ|ន្តៈ	វ・គ・្・គ・ន・្・ត・ៈ
វញ្ចទន្ត	វញ្ច|ទន្ត	វ・ញ・្・ច・ទ・ន・្・ត
វណ្ណវន្ត	វណ្ណ|វន្ត	វ・ណ・្・ណ・វ・ន・្・ត
វណ្ណវន្តី	វណ្ណ|វន្តី	វ・ណ・្・ណ・វ・ន・្・ត・ី
វត្តវន្ត	វត្ត|វន្ត	វ・ត・្・ត・វ・ន・្・ត
វត្តវន្តី	វត្ត|វន្តី	វ・ត・្・ត・វ・ន・្・ត・ី
វនន្តរ	វនន្តរ	វ・ន・ន・្・ត・រ
វន្ត	វន្ត	វ・ន・្・ត
វន្ទន្ត	វន្ទន្ត	វ・ន・្・ទ・ន・្・ត
វន្ទន្តី	វន្ទន្តី	វ・ន・្・ទ・ន・្・ត・ី
វរមន្ត្រី	វរ|មន្ត្រី	វ・រ・ម・ន・្・ត・្・រ・ី
វសន្តតិលក	វសន្ត|តិលក	វ・ស・ន・្・ត・ត・ិ・ល・ក
វសន្តរដូវ	វសន្ត|រដូវ	វ・ស・ន・្・ត・រ・ដ・ូ・វ
វសន្តរតូវ	វសន្តរ|តូវ	វ・ស・ន・្・ត・រ・ត・ូ・វ
វារិយន្ត្រ	វា|រិយន្ត្រ	វ・ា・រ・ិ・យ・ន・្・ត・្・រ
វាឡកន្តារ	វា|ឡកន្តារ	វ・ា・ឡ・ក・ន・្・ត・ា・រ
វិក្រាន្ត	វិក្រាន្ត	វ・ិ・ក・្・រ・ា・ន・្・ត
វិក្រាន្តយុទ្ធ	វិក្រាន្ត|យុទ្ធ	វ・ិ・ក・្・រ・ា・ន・្・ត・យ・ុ・ទ・្・ធ
វិក្រាន្តសង្គ្រាម	វិក្រាន្ត|សង្គ្រាម	វ・ិ・ក・្・រ・ា・ន・្・ត・ស・ង・្・គ・្・រ・ា・ម
វិចិន្តា	វិចិន្តា	វ・ិ・ច・ិ・ន・្・ត・ា
វិត្តន្តរាយ	វិត្តន្តរាយ	វ・ិ・ត・្・ត・ន・្・ត・រ・ា・យ
វិត្ថារន្តរ	វិត្ថា|រន្តរ	វ・ិ・ត・្・ថ・ា・រ・ន・្・ត・រ
វិធិវន្ត	វិធិវន្ត	វ・ិ・ធ・ិ・វ・ន・្・ត
វិនាសន្តរាយ	វិនាសន្តរាយ	វ・ិ・ន・ា・ស・ន・្・ត・រ・ា・យ
វិព្ភន្ត	វិព្ភន្ត	វ・ិ・ព・្・ភ・ន・្・ត
វិព្ភន្តក	វិព្ភន្តក	វ・ិ・ព・្・ភ・ន・្・ត・ក
វិព្ភន្តចិត្ត	វិព្ភន្ត|ចិត្ត	វ・ិ・ព・្・ភ・ន・្・ត・ច・ិ・ត・្・ត
វិព្ភន្តិកា	វិព្ភន្តិកា	វ・ិ・ព・្・ភ・ន・្・ត・ិ・ក・ា
វិព្ភ័ន្ត	វិព្ភ័ន្ត	វ・ិ・ព・្・ភ・័・ន・្・ត
វិសាលសន្តាន	វិសាល|សន្តាន	វ・ិ・ស・ា・ល・ស・ន・្・ត・ា・ន
វិសុទ្ធសន្តាន	វិសុទ្ធ|សន្តាន	វ・ិ・ស・ុ・ទ・្・ធ・ស・ន・្・ត・ា・ន
វិហង្គយន្ត្រ	វិហង្គ|យន្ត្រ	វ・ិ・ហ・ង・្・គ・យ・ន・្・ត・្・រ
វីរិយវន្ត	វីរិយ|វន្ត	វ・ី・រ・ិ・យ・វ・ន・្・ត
វីរិយវន្តី	វីរិយ|វន្តី	វ・ី・រ・ិ・យ・វ・ន・្・ត・ី
វូបសន្ត	វូប|សន្ត	វ・ូ・ប・ស・ន・្・ត
វូបសន្តចិត្ត	វូប|សន្ត|ចិត្ត	វ・ូ・ប・ស・ន・្・ត・ច・ិ・ត・្・ត
វូបសន្តដ្ឋាន	វូប|សន្ត|ដ្ឋាន	វ・ូ・ប・ស・ន・្・ត・ដ・្・ឋ・ា・ន
វេជយ័ន្ត	វេជយ័ន្ត	វ・េ・ជ・យ・័・ន・្・ត
វេទនាក្សាន្តិ	វេទនា|ក្សាន្តិ	វ・េ・ទ・ន・ា・ក・្・ស・ា・ន・្・ត・ិ
វេទន្ត	វេទន្ត	វ・េ・ទ・ន・្・ត
វេទមន្ត	វេទមន្ត	វ・េ・ទ・ម・ន・្・ត
វេទមន្ត្រ	វេទមន្ត្រ	វ・េ・ទ・ម・ន・្・ត・្・រ
វេទាន្ត	វេទាន្ត	វ・េ・ទ・ា・ន・្・ត
វេស្សន្តរ	វេស្សន្តរ	វ・េ・ស・្・ស・ន・្・ត・រ
វេស្សន្តរជាតក	វេស្សន្តរ|ជាតក	វ・េ・ស・្・ស・ន・្・ត・រ・ជ・ា・ត・ក
សក់កាន្ត	សក់|កាន្ត	ស・ក・់・ក・ា・ន・្・ត
សក់ក័ន្ត	សក់|ក័ន្ត	ស・ក・់・ក・័・ន・្・ត
សង្កិលេសិកសន្តាន	សង្កិលេសិក|សន្តាន	ស・ង・្・ក・ិ・ល・េ・ស・ិ・ក・ស・ន・្・ត・ា・ន
សង្ក្រាន្ត	សង្ក្រាន្ត	ស・ង・្・ក・្・រ・ា・ន・្・ត
សង្ក្រាន្តិ	សង្ក្រាន្តិ	ស・ង・្・ក・្・រ・ា・ន・្・ត・ិ
សជ្ឈន្តិក	សជ្ឈន្តិក	ស・ជ・្・ឈ・ន・្・ត・ិ・ក
សតិមន្ត	សតិ|មន្ត	ស・ត・ិ・ម・ន・្・ត
សតិមន្តី	សតិ|មន្តី	ស・ត・ិ・ម・ន・្・ត・ី
សទារសន្តោស	សទារ|សន្តោស	ស・ទ・ា・រ・ស・ន・្・ត・ោ・ស
សន្តតិ	សន្ត|តិ	ស・ន・្・ត・ត・ិ
សន្តតិកម្ម	សន្ត|តិ|កម្ម	ស・ន・្・ត・ត・ិ・ក・ម・្・ម
សន្តតិជន	សន្ត|តិជន	ស・ន・្・ត・ត・ិ・ជ・ន
សន្តតិវង្ស	សន្ត|តិវង្ស	ស・ន・្・ត・ត・ិ・វ・ង・្・ស
សន្តាន	សន្តាន	ស・ន・្・ត・ា・ន
សន្តានពាក្យ	សន្តាន|ពាក្យ	ស・ន・្・ត・ា・ន・ព・ា・ក・្・យ
សន្តានព្រៀងលាន	សន្តាន|ព្រៀង|លាន	ស・ន・្・ត・ា・ន・ព・្・រ・ៀ・ង・ល・ា・ន
សន្តានសន្ធិ	សន្តាន|សន្ធិ	ស・ន・្・ត・ា・ន・ស・ន・្・ធ・ិ
សន្តាប	សន្តាប	ស・ន・្・ត・ា・ប
សន្តាបចិត្ត	សន្តាប|ចិត្ត	ស・ន・្・ត・ា・ប・ច・ិ・ត・្・ត
សន្តាបទុក្ខ	សន្តា|បទុក្ខ	ស・ន・្・ត・ា・ប・ទ・ុ・ក・្・ខ
សន្តាបរោគ	សន្តាប|រោគ	ស・ន・្・ត・ា・ប・រ・ោ・គ
សន្តាបវេទនា	សន្តាប|វេទនា	ស・ន・្・ត・ា・ប・វ・េ・ទ・ន・ា
សន្តិ	សន្តិ	ស・ន・្・ត・ិ
សន្តិករ	សន្តិករ	ស・ន・្・ត・ិ・ក・រ
សន្តិការកៈ	សន្តិការ|កៈ	ស・ន・្・ត・ិ・ក・ា・រ・ក・ៈ
សន្តិការិកា	សន្តិការិកា	ស・ន・្・ត・ិ・ក・ា・រ・ិ・ក・ា
សន្តិកាល	សន្តិកាល	ស・ន・្・ត・ិ・ក・ា・ល
សន្តិនិយម	សន្តិ|និយម	ស・ន・្・ត・ិ・ន・ិ・យ・ម
សន្តិបទ	សន្តិបទ	ស・ន・្・ត・ិ・ប・ទ
សន្តិបាល	សន្តិបាល	ស・ន・្・ត・ិ・ប・ា・ល
សន្តិភាព	សន្តិភាព	ស・ន・្・ត・ិ・ភ・ា・ព
សន្តិភាពនិយម	សន្តិភាព|និយម	ស・ន・្・ត・ិ・ភ・ា・ព・ន・ិ・យ・ម
សន្តិភាវូបនីយកម្ម	សន្តិភាវូបនីយ|កម្ម	ស・ន・្・ត・ិ・ភ・ា・វ・ូ・ប・ន・ី・យ・ក・ម・្・ម
សន្តិវរបទ	សន្តិវរបទ	ស・ន・្・ត・ិ・វ・រ・ប・ទ
សន្តិវារបទ	សន្តិវារ|បទ	ស・ន・្・ត・ិ・វ・ា・រ・ប・ទ
សន្តិវិធី	សន្តិ|វិធី	ស・ន・្・ត・ិ・វ・ិ・ធ・ី
សន្តិសហវិជ្ជមាន	សន្តិសហ|វិជ្ជមាន	ស・ន・្・ត・ិ・ស・ហ・វ・ិ・ជ・្・ជ・ម・ា・ន
សន្តិសុខ	សន្តិសុខ	ស・ន・្・ត・ិ・ស・ុ・ខ
សន្តិហេតុ	សន្តិហេតុ	ស・ន・្・ត・ិ・ហ・េ・ត・ុ
សន្តុដ្ឋី	សន្តុដ្ឋី	ស・ន・្・ត・ុ・ដ・្・ឋ・ី
សន្តុដ្ឋីធម៌	សន្តុដ្ឋី|ធម៌	ស・ន・្・ត・ុ・ដ・្・ឋ・ី・ធ・ម・៌
សន្តុដ្ឋីភាព	សន្តុដ្ឋី|ភាព	ស・ន・្・ត・ុ・ដ・្・ឋ・ី・ភ・ា・ព
សន្តុដ្ឋីសុខ	សន្តុដ្ឋី|សុខ	ស・ន・្・ត・ុ・ដ・្・ឋ・ី・ស・ុ・ខ
សន្តុបាយ	សន្តុបាយ	ស・ន・្・ត・ុ・ប・ា・យ
សន្តោស	សន្តោស	ស・ន・្・ត・ោ・ស
សព្វន្តរាយ	សព្វន្តរាយ	ស・ព・្・វ・ន・្・ត・រ・ា・យ
សព្វសន្តិភាព	សព្វ|សន្តិភាព	ស・ព・្・វ・ស・ន・្・ត・ិ・ភ・ា・ព
សមចិន្តា	សម|ចិន្តា	ស・ម・ច・ិ・ន・្・ត・ា
សមុទ្ទកន្តា	សមុទ្ទ|កន្តា	ស・ម・ុ・ទ・្・ទ・ក・ន・្・ត・ា
សមុទ្ទកន្តារ	សមុទ្ទ|កន្តារ	ស・ម・ុ・ទ・្・ទ・ក・ន・្・ត・ា・រ
សមុទ្រកន្តារ	សមុទ្រ|កន្តារ	ស・ម・ុ・ទ・្・រ・ក・ន・្・ត・ា・រ
សមុទ្រកាន្តា	សមុទ្រ|កាន្តា	ស・ម・ុ・ទ・្・រ・ក・ា・ន・្・ត・ា
សម្ដីមានឱតភ័ន្ត	សម្ដី|មាន|ឱត|ភ័ន្ត	ស・ម・្・ដ・ី・ម・ា・ន・ឱ・ត・ភ・័・ន・្・ត
សម្រាកសម្រាន្ត	សម្រាក|សម្រាន្ត	ស・ម・្・រ・ា・ក・ស・ម・្・រ・ា・ន・្・ត
សម្រាន្ត	សម្រាន្ត	ស・ម・្・រ・ា・ន・្・ត
សម្រេចសម្រាន្ត	សម្រេច|សម្រាន្ត	ស・ម・្・រ・េ・ច・ស・ម・្・រ・ា・ន・្・ត
សរីរយន្ត	សរីរ|យន្ត	ស・រ・ី・រ・យ・ន・្・ត
សរីរយន្ត្រ	សរីរ|យន្ត្រ	ស・រ・ី・រ・យ・ន・្・ត・្・រ
សរីរាង្គបន្តពូជ	សរីរាង្គ|បន្ត|ពូជ	ស・រ・ី・រ・ា・ង・្・គ・ប・ន・្・ត・ព・ូ・ជ
សវន្តី	សវន្តី	ស・វ・ន・្・ត・ី
សាច់សន្តាន	សាច់|សន្តាន	ស・ា・ច・់・ស・ន・្・ត・ា・ន
សាន្ត	សាន្ត	ស・ា・ន・្・ត
សាន្តគ្រោះ	សាន្ត|គ្រោះ	ស・ា・ន・្・ត・គ・្・រ・ោ・ះ
សាន្តត្រាណ	សាន្តត្រាណ	ស・ា・ន・្・ត・ត・្・រ・ា・ណ
សាន្តសុខ	សាន្ត|សុខ	ស・ា・ន・្・ត・ស・ុ・ខ
សាន្តិ	សាន្តិ	ស・ា・ន・្・ត・ិ
សាន្តិរដ្ឋ	សាន្តិ|រដ្ឋ	ស・ា・ន・្・ត・ិ・រ・ដ・្・ឋ
សាមន្ត	សាមន្ត	ស・ា・ម・ន・្・ត
សាមន្តគ្រាម	សាមន្ត|គ្រាម	ស・ា・ម・ន・្・ត・គ・្・រ・ា・ម
សាមន្តប្រទេស	សាមន្ត|ប្រទេស	ស・ា・ម・ន・្・ត・ប・្・រ・ទ・េ・ស
សាមន្តរដ្ឋ	សាមន្ត|រដ្ឋ	ស・ា・ម・ន・្・ត・រ・ដ・្・ឋ
សាមន្តរាជ	សាមន្ត|រាជ	ស・ា・ម・ន・្・ត・រ・ា・ជ
សារវន្ត	សារវន្ត	ស・ា・រ・វ・ន・្・ត
សាលតន្ត្រី	សាល|តន្ត្រី	ស・ា・ល・ត・ន・្・ត・្・រ・ី
សិទ្ធន្ត	សិទ្ធ|ន្ត	ស・ិ・ទ・្・ធ・ន・្・ត
សិទ្ធមន្ត	សិទ្ធ|មន្ត	ស・ិ・ទ・្・ធ・ម・ន・្・ត
សិទ្ធាន្ត	សិទ្ធាន្ត	ស・ិ・ទ・្・ធ・ា・ន・្・ត
សិទ្ធាន្តនិយម	សិទ្ធាន្ត|និយម	ស・ិ・ទ・្・ធ・ា・ន・្・ត・ន・ិ・យ・ម
សិទ្ធិមន្ត	សិទ្ធិ|មន្ត	ស・ិ・ទ・្・ធ・ិ・ម・ន・្・ត
សិទ្ធិមន្ត្រ	សិទ្ធិ|មន្ត្រ	ស・ិ・ទ・្・ធ・ិ・ម・ន・្・ត・្・រ
សិទ្ធិវន្ត	សិទ្ធិ|វន្ត	ស・ិ・ទ・្・ធ・ិ・វ・ន・្・ត
សិនេហវន្ត	សិនេហ|វន្ត	ស・ិ・ន・េ・ហ・វ・ន・្・ត
សិនេហវន្តី	សិនេហ|វន្តី	ស・ិ・ន・េ・ហ・វ・ន・្・ត・ី
សិប្បវន្ត	សិប្បវន្ត	ស・ិ・ប・្・ប・វ・ន・្・ត
សិប្បវន្តី	សិប្បវន្តី	ស・ិ・ប・្・ប・វ・ន・្・ត・ី
សិព្វយន្ត	សិព្វ|យន្ត	ស・ិ・ព・្・វ・យ・ន・្・ត
សិរីមន្ត	សិរី|មន្ត	ស・ិ・រ・ី・ម・ន・្・ត
សិរីមន្តី	សិរី|មន្តី	ស・ិ・រ・ី・ម・ន・្・ត・ី
សិវមន្ត	សិវ|មន្ត	ស・ិ・វ・ម・ន・្・ត
សិវមន្ត្រ	សិវ|មន្ត្រ	ស・ិ・វ・ម・ន・្・ត・្・រ
សីទន្តរ	សី|ទន្តរ	ស・ី・ទ・ន・្・ត・រ
សីមន្តរិក	សី|មន្ត|រិក	ស・ី・ម・ន・្・ត・រ・ិ・ក
សីមន្តរិកបាសាណ	សី|មន្ត|រិក|បាសាណ	ស・ី・ម・ន・្・ត・រ・ិ・ក・ប・ា・ស・ា・ណ
សីលវន្ត	សីល|វន្ត	ស・ី・ល・វ・ន・្・ត
សីលវន្តី	សីល|វន្តី	ស・ី・ល・វ・ន・្・ត・ី
សុកាន្ត	សុកាន្ត	ស・ុ・ក・ា・ន・្・ត
សុក័ន្ត	សុក័ន្ត	ស・ុ・ក・័・ន・្・ត
សុក្កទន្ត	សុក្ក|ទន្ត	ស・ុ・ក・្・ក・ទ・ន・្・ត
សុខក្សេមក្សាន្ត	សុខ|ក្សេមក្សាន្ត	ស・ុ・ខ・ក・្・ស・េ・ម・ក・្・ស・ា・ន・្・ត
សុខសាន្ត	សុខ|សាន្ត	ស・ុ・ខ・ស・ា・ន・្・ត
សុខសាន្តត្រាណ	សុខ|សាន្តត្រាណ	ស・ុ・ខ・ស・ា・ន・្・ត・ត・្・រ・ា・ណ
សុខុមមន្តិនី	សុខុម|មន្តិនី	ស・ុ・ខ・ុ・ម・ម・ន・្・ត・ិ・ន・ី
សុខុមមន្តី	សុខុម|មន្តី	ស・ុ・ខ・ុ・ម・ម・ន・្・ត・ី
សុចិតចិន្តា	សុចិត|ចិន្តា	ស・ុ・ច・ិ・ត・ច・ិ・ន・្・ត・ា
សុចិទន្ត	សុចិទន្ត	ស・ុ・ច・ិ・ទ・ន・្・ត
សុត្តន្តបិដក	សុត្តន្ត|បិដក	ស・ុ・ត・្・ត・ន・្・ត・ប・ិ・ដ・ក
សុទន្ត	សុទន្ត	ស・ុ・ទ・ន・្・ត
សុទន្តចិត្ត	សុទន្ត|ចិត្ត	ស・ុ・ទ・ន・្・ត・ច・ិ・ត・្・ត
សុទន្តបុរស	សុទន្ត|បុរស	ស・ុ・ទ・ន・្・ត・ប・ុ・រ・ស
សុទន្តសត្ត	សុទន្ត|សត្ត	ស・ុ・ទ・ន・្・ត・ស・ត・្・ត
សុទន្តសត្វ	សុទន្ត|សត្វ	ស・ុ・ទ・ន・្・ត・ស・ត・្・វ
សុទន្តី	សុទន្តី	ស・ុ・ទ・ន・្・ត・ី
សុទ្ធិមន្ត	សុទ្ធិ|មន្ត	ស・ុ・ទ・្・ធ・ិ・ម・ន・្・ត
សុទ្ធិមន្តី	សុទ្ធិ|មន្តី	ស・ុ・ទ・្・ធ・ិ・ម・ន・្・ត・ី
សុទ្ធិមន្តីល	សុទ្ធិ|មន្តីល	ស・ុ・ទ・្・ធ・ិ・ម・ន・្・ត・ី・ល
សុរិយសន្តាប	សុរិយ|សន្តាប	ស・ុ・រ・ិ・យ・ស・ន・្・ត・ា・ប
សូករន្តកៈ	សូក|រន្តកៈ	ស・ូ・ក・រ・ន・្・ត・ក・ៈ
សូរ្យកាន្ត	សូរ្យកាន្ត	ស・ូ・រ・្・យ・ក・ា・ន・្・ត
សេន្ត	សេន្ត	ស・េ・ន・្・ត
សៃយមន្ត	សៃ|យមន្ត	ស・ៃ・យ・ម・ន・្・ត
សោកាន្ត	សោកាន្ត	ស・ោ・ក・ា・ន・្・ត
សោក័ន្ត	សោក័ន្ត	ស・ោ・ក・័・ន・្・ត
ស្ត្រីមន្ត្រ	ស្ត្រី|មន្ត្រ	ស・្・ត・្・រ・ី・ម・ន・្・ត・្・រ
ស្រវន្តី	ស្រវន្តី	ស・្・រ・វ・ន・្・ត・ី
ស្រាកស្រាន្ត	ស្រាកស្រាន្ត	ស・្・រ・ា・ក・ស・្・រ・ា・ន・្・ត
ស្រាន្ត	ស្រាន្ត	ស・្・រ・ា・ន・្・ត
ហនុមាន្ត	ហនុមាន្ត	ហ・ន・ុ・ម・ា・ន・្・ត
ហិមពាន្ត	ហិមពាន្ត	ហ・ិ・ម・ព・ា・ន・្・ត
ហិមវន្តប្បទេស	ហិមវន្ត|ប្បទេស	ហ・ិ・ម・វ・ន・្・ត・ប・្・ប・ទ・េ・ស
ហិមវន្តប្រទេស	ហិមវន្ត|ប្រទេស	ហ・ិ・ម・វ・ន・្・ត・ប・្・រ・ទ・េ・ស
ហិមវាន្ត	ហិម|វាន្ត	ហ・ិ・ម・វ・ា・ន・្・ត
ហិមវ័ន្ត	ហិមវ័ន្ត	ហ・ិ・ម・វ・័・ន・្・ត
ហិរិមន្ត	ហិរិមន្ត	ហ・ិ・រ・ិ・ម・ន・្・ត
ហិរិមន្តី	ហិរិមន្តី	ហ・ិ・រ・ិ・ម・ន・្・ត・ី
ហេតុមន្ត	ហេតុ|មន្ត	ហ・េ・ត・ុ・ម・ន・្・ត
ហេមន្ត	ហេមន្ត	ហ・េ・ម・ន・្・ត
ហេមន្តកាល	ហេមន្ត|កាល	ហ・េ・ម・ន・្・ត・ក・ា・ល
ហេមន្តជីព	ហេមន្ត|ជីព	ហ・េ・ម・ន・្・ត・ជ・ី・ព
ហេមន្តរដូវ	ហេមន្ត|រដូវ	ហ・េ・ម・ន・្・ត・រ・ដ・ូ・វ
ហេមន្តសម័យ	ហេមន្ត|សម័យ	ហ・េ・ម・ន・្・ត・ស・ម・័・យ
ហេមន្ត—	ហេមន្ត—	ហ・េ・ម・ន・្・ត・—
ហេមពាន្ត	ហេមពាន្ត	ហ・េ・ម・ព・ា・ន・្・ត
ហេមវ័ន្ត	ហេមវ័ន្ត	ហ・េ・ម・វ・័・ន・្・ត
ហេម្បូពាន្ត	ហេ|ម្បូ|ពាន្ត	ហ・េ・ម・្・ប・ូ・ព・ា・ន・្・ត
អក្ខន្តី	អក្ខន្តី	អ・ក・្・ខ・ន・្・ត・ី
អក្សាន្តី	អក្សាន្តី	អ・ក・្・ស・ា・ន・្・ត・ី
អខន្តិភាព	អខន្តិភាព	អ・ខ・ន・្・ត・ិ・ភ・ា・ព
អគ្គមន្ត្រី	អគ្គ|មន្ត្រី	អ・គ・្・គ・ម・ន・្・ត・្・រ・ី
អគ្គិសន្តាប	អគ្គិសន្តាប	អ・គ・្・គ・ិ・ស・ន・្・ត・ា・ប
អគ្រមន្ត្រី	អគ្រមន្ត្រី	អ・គ・្・រ・ម・ន・្・ត・្・រ・ី
អង្គមន្ត្រី	អង្គ|មន្ត្រី	អ・ង・្・គ・ម・ន・្・ត・្・រ・ី
អង្គមន្ត្រីសភា	អង្គ|មន្ត្រី|សភា	អ・ង・្・គ・ម・ន・្・ត・្・រ・ី・ស・ភ・ា
អង្សុមន្ត	អង្សុមន្ត	អ・ង・្・ស・ុ・ម・ន・្・ត
អចិន្តា	អចិន្តា	អ・ច・ិ・ន・្・ត・ា
អចិន្ត្រៃយ៍	អចិន្ត្រៃយ៍	អ・ច・ិ・ន・្・ត・្・រ・ៃ・យ・៍
អច្ចន្តិកជន	អច្ចន្តិក|ជន	អ・ច・្・ច・ន・្・ត・ិ・ក・ជ・ន
អច្ចន្តិកនិយម	អច្ចន្តិក|និយម	អ・ច・្・ច・ន・្・ត・ិ・ក・ន・ិ・យ・ម
អច្ចន្តិកបុគ្គល	អច្ចន្តិក|បុគ្គល	អ・ច・្・ច・ន・្・ត・ិ・ក・ប・ុ・គ・្・គ・ល
អជ្ឈត្តសន្តាន	អជ្ឈត្ត|សន្តាន	អ・ជ・្・ឈ・ត・្・ត・ស・ន・្・ត・ា・ន
អតិមហន្ត	អតិមហន្ត	អ・ត・ិ・ម・ហ・ន・្・ត
អតិមហន្តី	អតិមហន្តី	អ・ត・ិ・ម・ហ・ន・្・ត・ី
អតិសន្តាប	អតិសន្តាប	អ・ត・ិ・ស・ន・្・ត・ា・ប
អតីតមន្ត្រី	អតីត|មន្ត្រី	អ・ត・ី・ត・ម・ន・្・ត・្・រ・ី
អតីតរដ្ឋមន្ត្រី	អតីត|រដ្ឋ|មន្ត្រី	អ・ត・ី・ត・រ・ដ・្・ឋ・ម・ន・្・ត・្・រ・ី
អត្តទន្ត	អត្ត|ទន្ត	អ・ត・្・ត・ទ・ន・្・ត
អត្តទន្តី	អត្ត|ទន្តី	អ・ត・្・ត・ទ・ន・្・ត・ី
អត្ថចិន្តា	អត្ថ|ចិន្តា	អ・ត・្・ថ・ច・ិ・ន・្・ត・ា
អថិរវន្ត	អថិរវន្ត	អ・ថ・ិ・រ・វ・ន・្・ត
អធិវាសក្សាន្តី	អធិវា|សក្សាន្តី	អ・ធ・ិ・វ・ា・ស・ក・្・ស・ា・ន・្・ត・ី
អធិវាសនក្ខន្តី	អធិវាសន|ក្ខន្តី	អ・ធ・ិ・វ・ា・ស・ន・ក・្・ខ・ន・្・ត・ី
អធិវាសនក្សាន្តី	អធិវាសន|ក្សាន្តី	អ・ធ・ិ・វ・ា・ស・ន・ក・្・ស・ា・ន・្・ត・ី
អនន្ត	អនន្ត	អ・ន・ន・្・ត
អនន្តកាល	អនន្ត|កាល	អ・ន・ន・្・ត・ក・ា・ល
អនន្តគុណ	អនន្ត|គុណ	អ・ន・ន・្・ត・គ・ុ・ណ
អនន្តញ្ញាណ	អនន្តញ្ញាណ	អ・ន・ន・្・ត・ញ・្・ញ・ា・ណ
អនន្តភាព	អនន្ត|ភាព	អ・ន・ន・្・ត・ភ・ា・ព
អនន្តរ	អនន្តរ	អ・ន・ន・្・ត・រ
អនន្តរកថា	អនន្តរក|ថា	អ・ន・ន・្・ត・រ・ក・ថ・ា
អនន្តរគមនាគមន៍	អនន្តរ|គមនាគមន៍	អ・ន・ន・្・ត・រ・គ・ម・ន・ា・គ・ម・ន・៍
អនន្តរបុស្ប	អនន្តរ|បុស្ប	អ・ន・ន・្・ត・រ・ប・ុ・ស・្・ប
អនន្តរផល	អនន្តរ|ផល	អ・ន・ន・្・ត・រ・ផ・ល
អនន្តរាគមន៍	អនន្តរាគមន៍	អ・ន・ន・្・ត・រ・ា・គ・ម・ន・៍
អនន្តរិយកម្ម	អនន្តរិយ|កម្ម	អ・ន・ន・្・ត・រ・ិ・យ・ក・ម・្・ម
អនន្តរ—	អនន្តរ—	អ・ន・ន・្・ត・រ・—
អនន្តារម្មណ៍	អនន្តារម្មណ៍	អ・ន・ន・្・ត・ា・រ・ម・្・ម・ណ・៍
អនន្តា—	អនន្តា—	អ・ន・ន・្・ត・ា・—
អនន្ត—	អនន្ត—	អ・ន・ន・្・ត・—
អនិមន្តន៍	អនិមន្តន៍	អ・ន・ិ・ម・ន・្・ត・ន・៍
អនុចិន្តា	អនុចិន្តា	អ・ន・ុ・ច・ិ・ន・្・ត・ា
អនុនាសិកន្ត	អនុនា|សិកន្ត	អ・ន・ុ・ន・ា・ស・ិ・ក・ន・្・ត
អនុមន្ត្រី	អនុមន្ត្រី	អ・ន・ុ・ម・ន・្・ត・្・រ・ី
អនុយ័ន្ត	អនុយ័ន្ត	អ・ន・ុ・យ・័・ន・្・ត
អនេកអនន្ត	អនេក|អនន្ត	អ・ន・េ・ក・អ・ន・ន・្・ត
អន្ត	អន្ត	អ・ន・្・ត
អន្តកម្ម	អន្ត|កម្ម	អ・ន・្・ត・ក・ម・្・ម
អន្តករ	អន្តករ	អ・ន・្・ត・ក・រ
អន្តកាល	អន្តកាល	អ・ន・្・ត・ក・ា・ល
អន្តគត	អន្តគត	អ・ន・្・ត・គ・ត
អន្តគតា	អន្ត|គតា	អ・ន・្・ត・គ・ត・ា
អន្តគុណ	អន្ត|គុណ	អ・ន・្・ត・គ・ុ・ណ
អន្តគុណំ	អន្ត|គុណំ	អ・ន・្・ត・គ・ុ・ណ・ំ
អន្តគូ	អន្ត|គូ	អ・ន・្・ត・គ・ូ
អន្តជាតិ	អន្ត|ជាតិ	អ・ន・្・ត・ជ・ា・ត・ិ
អន្តធម៌	អន្តធម៌	អ・ន・្・ត・ធ・ម・៌
អន្តព័ណ៌	អន្ត|ព័ណ៌	អ・ន・្・ត・ព・័・ណ・៌
អន្តយ	អន្តយ	អ・ន・្・ត・យ
អន្តរ	អន្តរ	អ・ន・្・ត・រ
អន្តរ!	អន្តរ|!	អ・ន・្・ត・រ・!
អន្តរកប្ប	អន្តរ|កប្ប	អ・ន・្・ត・រ・ក・ប・្・ប
អន្តរកម្ម	អន្តរ|កម្ម	អ・ន・្・ត・រ・ក・ម・្・ម
អន្តរកម្មនិយម	អន្តរ|កម្ម|និយម	អ・ន・្・ត・រ・ក・ម・្・ម・ន・ិ・យ・ម
អន្តរកម្មនៃបណ្ដាញ	អន្តរ|កម្ម|នៃ|បណ្ដាញ	អ・ន・្・ត・រ・ក・ម・្・ម・ន・ៃ・ប・ណ・្・ដ・ា・ញ
អន្តរការណ៍	អន្តរ|ការណ៍	អ・ន・្・ត・រ・ក・ា・រ・ណ・៍
អន្តរការី	អន្តរ|ការី	អ・ន・្・ត・រ・ក・ា・រ・ី
អន្តរកាល	អន្តរ|កាល	អ・ន・្・ត・រ・ក・ា・ល
អន្តរក្រសួង	អន្តរ|ក្រសួង	អ・ន・្・ត・រ・ក・្・រ・ស・ួ・ង
អន្តរគវេសិនី	អន្តរ|គវេសិនី	អ・ន・្・ត・រ・គ・វ・េ・ស・ិ・ន・ី
អន្តរគវេសី	អន្តរ|គវេសី	អ・ន・្・ត・រ・គ・វ・េ・ស・ី
អន្តរគ្រឹះ	អន្តរ|គ្រឹះ	អ・ន・្・ត・រ・គ・្・រ・ឹ・ះ
អន្តរចិត្តវិជ្ជា	អន្តរ|ចិត្ត|វិជ្ជា	អ・ន・្・ត・រ・ច・ិ・ត・្・ត・វ・ិ・ជ・្・ជ・ា
អន្តរជាតិ	អន្តរ|ជាតិ	អ・ន・្・ត・រ・ជ・ា・ត・ិ
អន្តរជាតិនិយម	អន្តរ|ជាតិ|និយម	អ・ន・្・ត・រ・ជ・ា・ត・ិ・ន・ិ・យ・ម
អន្តរជាតូបនីយកម្ម	អន្តរ|ជាតូបនីយ|កម្ម	អ・ន・្・ត・រ・ជ・ា・ត・ូ・ប・ន・ី・យ・ក・ម・្・ម
អន្តរដ្ឋកា	អន្តរដ្ឋ|កា	អ・ន・្・ត・រ・ដ・្・ឋ・ក・ា
អន្តរត្តិភាព	អន្តរ|ត្តិភាព	អ・ន・្・ត・រ・ត・្・ត・ិ・ភ・ា・ព
អន្តរត្ថវាចក	អន្តរ|ត្ថ|វាចក	អ・ន・្・ត・រ・ត・្・ថ・វ・ា・ច・ក
អន្តរទ្វីប	អន្តរ|ទ្វីប	អ・ន・្・ត・រ・ទ・្・វ・ី・ប
អន្តរធាន	អន្តរធាន	អ・ន・្・ត・រ・ធ・ា・ន
អន្តរធានទៅ!	អន្តរធាន|ទៅ|!	អ・ន・្・ត・រ・ធ・ា・ន・ទ・ៅ・!
អន្តរបណ្ដាញ	អន្តរ|បណ្ដាញ	អ・ន・្・ត・រ・ប・ណ・្・ដ・ា・ញ
អន្តរប្បញ្ញត្តិ	អន្តរ|ប្បញ្ញត្តិ	អ・ន・្・ត・រ・ប・្・ប・ញ・្・ញ・ត・្・ត・ិ
អន្តរប្រទេស	អន្តរ|ប្រទេស	អ・ន・្・ត・រ・ប・្・រ・ទ・េ・ស
អន្តរភព	អន្តរភព	អ・ន・្・ត・រ・ភ・ព
អន្តរមាគ៌ា	អន្តរ|មាគ៌ា	អ・ន・្・ត・រ・ម・ា・គ・៌・ា
អន្តរមុខ	អន្តរ|មុខ	អ・ន・្・ត・រ・ម・ុ・ខ
អន្តររដ្ឋ	អន្តរ|រដ្ឋ	អ・ន・្・ត・រ・រ・ដ・្・ឋ
អន្តររដ្ឋាភិបាល	អន្តរ|រដ្ឋាភិបាល	អ・ន・្・ត・រ・រ・ដ・្・ឋ・ា・ភ・ិ・ប・ា・ល
អន្តរវាសក	អន្តរ|វាសក	អ・ន・្・ត・រ・វ・ា・ស・ក
អន្តរវាសកៈ	អន្តរ|វាសកៈ	អ・ន・្・ត・រ・វ・ា・ស・ក・ៈ
អន្តរវិស័យ	អន្តរ|វិស័យ	អ・ន・្・ត・រ・វ・ិ・ស・័・យ
អន្តរសភា	អន្តរសភា	អ・ន・្・ត・រ・ស・ភ・ា
អន្តរសម័យ	អន្តរ|សម័យ	អ・ន・្・ត・រ・ស・ម・័・យ
អន្តរស្ថាប័ន	អន្តរ|ស្ថាប័ន	អ・ន・្・ត・រ・ស・្・ថ・ា・ប・័・ន
អន្តរហេតុ	អន្តរ|ហេតុ	អ・ន・្・ត・រ・ហ・េ・ត・ុ
អន្តរា	អន្តរា	អ・ន・្・ត・រ・ា
អន្តរាកថា	អន្តរាក|ថា	អ・ន・្・ត・រ・ា・ក・ថ・ា
អន្តរាគមនិយម	អន្តរាគម|និយម	អ・ន・្・ត・រ・ា・គ・ម・ន・ិ・យ・ម
អន្តរាគមន៍	អន្តរាគមន៍	អ・ន・្・ត・រ・ា・គ・ម・ន・៍
អន្តរាត្មា	អន្តរាត្មា	អ・ន・្・ត・រ・ា・ត・្・ម・ា
អន្តរាត្ម័ន	អន្តរាត្ម័ន	អ・ន・្・ត・រ・ា・ត・្・ម・័・ន
អន្តរាបត្តិ	អន្តរាបត្តិ	អ・ន・្・ត・រ・ា・ប・ត・្・ត・ិ
អន្តរាមគ្គ	អន្តរាមគ្គ	អ・ន・្・ត・រ・ា・ម・គ・្・គ
អន្តរាយ	អន្តរាយ	អ・ន・្・ត・រ・ា・យ
អន្តរាយិកធម៌	អន្តរាយិក|ធម៌	អ・ន・្・ត・រ・ា・យ・ិ・ក・ធ・ម・៌
អន្តរាសន្និបាត	អន្តរាសន្និបាត	អ・ន・្・ត・រ・ា・ស・ន・្・ន・ិ・ប・ា・ត
អន្តរាសភា	អន្តរាសភា	អ・ន・្・ត・រ・ា・ស・ភ・ា
អន្តរា—	អន្តរា—	អ・ន・្・ត・រ・ា・—
អន្តរីក្ស	អន្តរី|ក្ស	អ・ន・្・ត・រ・ី・ក・្・ស
អន្តរីប	អន្តរីប	អ・ន・្・ត・រ・ី・ប
អន្តរេន្ទ្រិយ	អន្តរេន្ទ្រិយ	អ・ន・្・ត・រ・េ・ន・្・ទ・្・រ・ិ・យ
អន្តរ–	អន្តរ|–	អ・ន・្・ត・រ・–
អន្តរ—	អន្តរ—	អ・ន・្・ត・រ・—
អន្តលិក្ខ	អន្ត|លិក្ខ	អ・ន・្・ត・ល・ិ・ក・្・ខ
អន្តវណ្ណ	អន្ត|វណ្ណ	អ・ន・្・ត・វ・ណ・្・ណ
អន្តវាសិន	អន្ត|វា|សិន	អ・ន・្・ត・វ・ា・ស・ិ・ន
អន្តវាសិនី	អន្ត|វា|សិនី	អ・ន・្・ត・វ・ា・ស・ិ・ន・ី
អន្តសយ្យា	អន្ត|សយ្យា	អ・ន・្・ត・ស・យ・្・យ・ា
អន្តសេយ្យា	អន្ត|សេយ្យា	អ・ន・្・ត・ស・េ・យ・្・យ・ា
អន្តាក់អន្តិច	អន្តាក់|អន្តិច	អ・ន・្・ត・ា・ក・់・អ・ន・្・ត・ិ・ច
អន្តាក់អន្តិច	អន្តាក់|អន្តិច	អ・ន・្・ត・ា・ក・់・អ・ន・្・ត・ិ・ច
អន្តាយ	អន្តាយ	អ・ន・្・ត・ា・យ
អន្តិតអន្តូង	អន្តិត|អន្តូង	អ・ន・្・ត・ិ・ត・អ・ន・្・ត・ូ・ង
អន្តិតអន្តូង	អន្តិត|អន្តូង	អ・ន・្・ត・ិ・ត・អ・ន・្・ត・ូ・ង
អន្តិម	អន្តិម	អ・ន・្・ត・ិ・ម
អន្តិមកិច្ច	អន្តិ|មកិច្ច	អ・ន・្・ត・ិ・ម・ក・ិ・ច・្・ច
អន្តិមជាតិ	អន្តិម|ជាតិ	អ・ន・្・ត・ិ・ម・ជ・ា・ត・ិ
អន្តិមត្តភាព	អន្តិ|មត្ត|ភាព	អ・ន・្・ត・ិ・ម・ត・្・ត・ភ・ា・ព
អន្តិមទេហធារី	អន្តិម|ទេហ|ធារី	អ・ន・្・ត・ិ・ម・ទ・េ・ហ・ធ・ា・រ・ី
អន្តិមភព	អន្តិមភព	អ・ន・្・ត・ិ・ម・ភ・ព
អន្តិមវត្ថុ	អន្តិមវត្ថុ	អ・ន・្・ត・ិ・ម・វ・ត・្・ថ・ុ
អន្តិមវត្ថុអជ្ឈាបនក	អន្តិមវត្ថុ|អជ្ឈាបនក	អ・ន・្・ត・ិ・ម・វ・ត・្・ថ・ុ・អ・ជ・្・ឈ・ា・ប・ន・ក
អន្តិមសាសន៍	អន្តិមសាសន៍	អ・ន・្・ត・ិ・ម・ស・ា・ស・ន・៍
អន្តិម—	អន្តិម—	អ・ន・្・ត・ិ・ម・—
អន្តឺត	អន្តឺត	អ・ន・្・ត・ឺ・ត
អន្តឺរ៉ឺរ៉ឺត	អន្តឺរ៉ឺរ៉ឺត	អ・ន・្・ត・ឺ・រ・៉・ឺ・រ・៉・ឺ・ត
អន្តុយ	អន្តុយ	អ・ន・្・ត・ុ・យ
អន្តុល	អន្តុល	អ・ន・្・ត・ុ・ល
អន្តេ	អន្តេ	អ・ន・្・ត・េ
អន្តេបទ	អន្តេបទ	អ・ន・្・ត・េ・ប・ទ
អន្តេបអន្តាប	អន្តេប|អន្តាប	អ・ន・្・ត・េ・ប・អ・ន・្・ត・ា・ប
អន្តេបអន្តាប	អន្តេប|អន្តាប	អ・ន・្・ត・េ・ប・អ・ន・្・ត・ា・ប
អន្តេបុរ	អន្តេ|បុរ	អ・ន・្・ត・េ・ប・ុ・រ
អន្តេបុរចរ	អន្តេ|បុរចរ	អ・ន・្・ត・េ・ប・ុ・រ・ច・រ
អន្តេបុរចារក	អន្តេ|បុរ|ចារក	អ・ន・្・ត・េ・ប・ុ・រ・ច・ា・រ・ក
អន្តេបុរចារកៈ	អន្តេ|បុរ|ចារកៈ	អ・ន・្・ត・េ・ប・ុ・រ・ច・ា・រ・ក・ៈ
អន្តេបុរចារិកា	អន្តេ|បុរ|ចារិកា	អ・ន・្・ត・េ・ប・ុ・រ・ច・ា・រ・ិ・ក・ា
អន្តេបុរបរិចារិកា	អន្តេ|បុរ|បរិចារិកា	អ・ន・្・ត・េ・ប・ុ・រ・ប・រ・ិ・ច・ា・រ・ិ・ក・ា
អន្តេបុរបាល	អន្តេ|បុរបាល	អ・ន・្・ត・េ・ប・ុ・រ・ប・ា・ល
អន្តេបុរបាលក	អន្តេ|បុរបាល|ក	អ・ន・្・ត・េ・ប・ុ・រ・ប・ា・ល・ក
អន្តេបុរបាលកៈ	អន្តេ|បុរបាលកៈ	អ・ន・្・ត・េ・ប・ុ・រ・ប・ា・ល・ក・ៈ
អន្តេបុរបាលិកា	អន្តេ|បុរបាលិកា	អ・ន・្・ត・េ・ប・ុ・រ・ប・ា・ល・ិ・ក・ា
អន្តេបុរិក	អន្តេ|បុរិក	អ・ន・្・ត・េ・ប・ុ・រ・ិ・ក
អន្តេបុរិកា	អន្តេ|បុរិកា	អ・ន・្・ត・េ・ប・ុ・រ・ិ・ក・ា
អន្តេបុរិកៈ	អន្តេ|បុរិកៈ	អ・ន・្・ត・េ・ប・ុ・រ・ិ・ក・ៈ
អន្តេបុរៈ	អន្តេ|បុរៈ	អ・ន・្・ត・េ・ប・ុ・រ・ៈ
អន្តេវាសិក	អន្តេវាសិក	អ・ន・្・ត・េ・វ・ា・ស・ិ・ក
អន្តេវាសិកដ្ឋាន	អន្តេវាសិក|ដ្ឋាន	អ・ន・្・ត・េ・វ・ា・ស・ិ・ក・ដ・្・ឋ・ា・ន
អន្តេវាសិន	អន្តេវា|សិន	អ・ន・្・ត・េ・វ・ា・ស・ិ・ន
អន្តេវាសិនី	អន្តេវា|សិនី	អ・ន・្・ត・េ・វ・ា・ស・ិ・ន・ី
អន្តេវាសី	អន្តេវាសី	អ・ន・្・ត・េ・វ・ា・ស・ី
អន្តេ—	អន្តេ—	អ・ន・្・ត・េ・—
អន្តែងអន្តៃ	អន្តែង|អន្តៃ	អ・ន・្・ត・ែ・ង・អ・ន・្・ត・ៃ
អន្តែងអន្តៃ	អន្តែង|អន្តៃ	អ・ន・្・ត・ែ・ង・អ・ន・្・ត・ៃ
អន្តោ	អន្តោ	អ・ន・្・ត・ោ
អន្តោគ្រាម	អន្តោគ្រាម	អ・ន・្・ត・ោ・គ・្・រ・ា・ម
អន្តោគ្រឹះ	អន្តោគ្រឹះ	អ・ន・្・ត・ោ・គ・្・រ・ឹ・ះ
អន្តោជន	អន្តោជន	អ・ន・្・ត・ោ・ជ・ន
អន្តោជាត	អន្តោជាត	អ・ន・្・ត・ោ・ជ・ា・ត
អន្តោជាតា	អន្តោជា|តា	អ・ន・្・ត・ោ・ជ・ា・ត・ា
អន្តោនគរ	អន្តោនគរ	អ・ន・្・ត・ោ・ន・គ・រ
អន្តោប្រវេសន៍	អន្តោប្រវេសន៍	អ・ន・្・ត・ោ・ប・្・រ・វ・េ・ស・ន・៍
អន្តោប្រវេសន្ត	អន្តោប្រវេសន្ត	អ・ន・្・ត・ោ・ប・្・រ・វ・េ・ស・ន・្・ត
អន្តោប្រវេសន្ត	អន្តោប្រវេសន្ត	អ・ន・្・ត・ោ・ប・្・រ・វ・េ・ស・ន・្・ត
អន្តោប្រាសាទ	អន្តោប្រាសាទ	អ・ន・្・ត・ោ・ប・្・រ・ា・ស・ា・ទ
អន្តោពាណិជ្ជ	អន្តោ|ពាណិជ្ជ	អ・ន・្・ត・ោ・ព・ា・ណ・ិ・ជ・្・ជ
អន្តោភិបាល	អន្តោភិបាល	អ・ន・្・ត・ោ・ភ・ិ・ប・ា・ល
អន្តោសារ	អន្តោសារ	អ・ន・្・ត・ោ・ស・ា・រ
អន្តោសារជាតិ	អន្តោសារ|ជាតិ	អ・ន・្・ត・ោ・ស・ា・រ・ជ・ា・ត・ិ
អន្តោសារព្រឹក្ស	អន្តោសារ|ព្រឹក្ស	អ・ន・្・ត・ោ・ស・ា・រ・ព・្・រ・ឹ・ក・្・ស
អន្តោ—	អន្តោ—	អ・ន・្・ត・ោ・—
អន្តំ	អន្តំ	អ・ន・្・ត・ំ
អន្តៈ	អន្តៈ	អ・ន・្・ត・ៈ
អន្ត្រត	អន្ត្រត	អ・ន・្・ត・្・រ・ត
អន្ត្រាក់	អន្ត្រាក់	អ・ន・្・ត・្・រ・ា・ក・់
អន្ត្រឹក	អន្ត្រឹក	អ・ន・្・ត・្・រ・ឹ・ក
អន្ត្រុក	អន្ត្រុក	អ・ន・្・ត・្・រ・ុ・ក
អន្ត្រើក	អន្ត្រើក	អ・ន・្・ត・្・រ・ើ・ក
អន្ត្រោក	អន្ត្រោក	អ・ន・្・ត・្・រ・ោ・ក
អន្ត—	អន្ត—	អ・ន・្・ត・—
អប្បសាន្ត	អប្បសាន្ត	អ・ប・្・ប・ស・ា・ន・្・ត
អប្សាន្ត	អប្សាន្ត	អ・ប・្・ស・ា・ន・្・ត
អផ្សុកអប្បសាន្ត	អផ្សុក|អប្បសាន្ត	អ・ផ・្・ស・ុ・ក・អ・ប・្・ប・ស・ា・ន・្・ត
អផ្សុកអប្សាន្ត	អផ្សុក|អប្សាន្ត	អ・ផ・្・ស・ុ・ក・អ・ប・្・ស・ា・ន・្・ត
អព្ភន្តរ	អព្ភន្តរ	អ・ព・្・ភ・ន・្・ត・រ
អព្ភន្តរកិរិយា	អព្ភន្តរ|កិរិយា	អ・ព・្・ភ・ន・្・ត・រ・ក・ិ・រ・ិ・យ・ា
អព្ភន្តរញ្ញាណ	អព្ភន្ត|រញ្ញាណ	អ・ព・្・ភ・ន・្・ត・រ・ញ・្・ញ・ា・ណ
អព្ភន្តរញ្ញាណនិយម	អព្ភន្ត|រញ្ញាណ|និយម	អ・ព・្・ភ・ន・្・ត・រ・ញ・្・ញ・ា・ណ・ន・ិ・យ・ម
អព្ភន្តរត្ថ	អព្ភន្តរ|ត្ថ	អ・ព・្・ភ・ន・្・ត・រ・ត・្・ថ
អព្ភន្តរសញ្ញា	អព្ភន្តរ|សញ្ញា	អ・ព・្・ភ・ន・្・ត・រ・ស・ញ・្・ញ・ា
អព្ភន្តរសព្ទ	អព្ភន្តរ|សព្ទ	អ・ព・្・ភ・ន・្・ត・រ・ស・ព・្・ទ
អព្ភន្តរសីមា	អព្ភន្តរ|សីមា	អ・ព・្・ភ・ន・្・ត・រ・ស・ី・ម・ា
អព្ភន្តរស័ព្ទ	អព្ភន្តរស័ព្ទ	អ・ព・្・ភ・ន・្・ត・រ・ស・័・ព・្・ទ
អព្ភន្តរ័ត្ថ	អព្ភន្តរ័ត្ថ	អ・ព・្・ភ・ន・្・ត・រ・័・ត・្・ថ
អព្ភន្តរ—	អព្ភន្តរ—	អ・ព・្・ភ・ន・្・ត・រ・—
អភយន្តរាយ	អភយន្តរាយ	អ・ភ・យ・ន・្・ត・រ・ា・យ
អភិក្កន្តព័ណ៌	អភិក្កន្ត|ព័ណ៌	អ・ភ・ិ・ក・្・ក・ន・្・ត・ព・័・ណ・៌
អភិក្កន្តវណ្ណ	អភិក្កន្ត|វណ្ណ	អ・ភ・ិ・ក・្・ក・ន・្・ត・វ・ណ・្・ណ
អភិក្កាន្តព័ណ៌	អភិក្កាន្ត|ព័ណ៌	អ・ភ・ិ・ក・្・ក・ា・ន・្・ត・ព・័・ណ・៌
អភិរដ្ឋមន្ត្រី	អភិរដ្ឋ|មន្ត្រី	អ・ភ・ិ・រ・ដ・្・ឋ・ម・ន・្・ត・្・រ・ី
អភិរាស្ត្រមន្ត្រី	អភិរាស្ត្រ|មន្ត្រី	អ・ភ・ិ・រ・ា・ស・្・ត・្・រ・ម・ន・្・ត・្・រ・ី
អភិសន្តាប	អភិសន្តាប	អ・ភ・ិ・ស・ន・្・ត・ា・ប
អមជ្ឈន្តិក	អមជ្ឈន្តិក	អ・ម・ជ・្・ឈ・ន・្・ត・ិ・ក
អមនុស្សកន្តារ	អមនុស្ស|កន្តារ	អ・ម・ន・ុ・ស・្・ស・ក・ន・្・ត・ា・រ
អយស្កាន្ត	អយស្កាន្ត	អ・យ・ស・្・ក・ា・ន・្・ត
អរហន្ត	អរហន្ត	អ・រ・ហ・ន・្・ត
អរហន្តា	អរហន្តា	អ・រ・ហ・ន・្・ត・ា
អរហន្តី	អរហន្តី	អ・រ・ហ・ន・្・ត・ី
អរហន្តោ	អរហន្តោ	អ・រ・ហ・ន・្・ត・ោ
អសន្តិសុខ	អសន្តិសុខ	អ・ស・ន・្・ត・ិ・ស・ុ・ខ
អសុចិទន្ត	អសុចិទន្ត	អ・ស・ុ・ច・ិ・ទ・ន・្・ត
អសុចិសន្តាន	អសុចិសន្តាន	អ・ស・ុ・ច・ិ・ស・ន・្・ត・ា・ន
អសុទ្ធិមន្ត	អសុទ្ធិ|មន្ត	អ・ស・ុ・ទ・្・ធ・ិ・ម・ន・្・ត
អសុទ្ធិមន្តី	អសុទ្ធិ|មន្តី	អ・ស・ុ・ទ・្・ធ・ិ・ម・ន・្・ត・ី
អស្ថិរវន្ត	អស្ថិរវន្ត	អ・ស・្・ថ・ិ・រ・វ・ន・្・ត
អហិមន្ត	អហិមន្ត	អ・ហ・ិ・ម・ន・្・ត
អហិមន្ត្រ	អហិមន្ត្រ	អ・ហ・ិ・ម・ន・្・ត・្・រ
អាកុលចិន្តា	អាកុល|ចិន្តា	អ・ា・ក・ុ・ល・ច・ិ・ន・្・ត・ា
អាគន្តុ	អាគន្តុ	អ・ា・គ・ន・្・ត・ុ
អាគន្តុក	អាគន្តុក	អ・ា・គ・ន・្・ត・ុ・ក
អាគន្តុកជន	អាគន្តុក|ជន	អ・ា・គ・ន・្・ត・ុ・ក・ជ・ន
អាគន្តុកទាន	អាគន្តុក|ទាន	អ・ា・គ・ន・្・ត・ុ・ក・ទ・ា・ន
អាគន្តុកប័ដ	អាគន្តុក|ប័ដ	អ・ា・គ・ន・្・ត・ុ・ក・ប・័・ដ
អាគន្តុកប្បដិសណ្ឋារ	អាគន្តុក|ប្បដិសណ្ឋារ	អ・ា・គ・ន・្・ត・ុ・ក・ប・្・ប・ដ・ិ・ស・ណ・្・ឋ・ា・រ
អាគន្តុកប្បដិសណ្ឋារៈ	អាគន្តុក|ប្បដិសណ្ឋារៈ	អ・ា・គ・ន・្・ត・ុ・ក・ប・្・ប・ដ・ិ・ស・ណ・្・ឋ・ា・រ・ៈ
អាគន្តុកភត្ត	អាគន្តុក|ភត្ត	អ・ា・គ・ន・្・ត・ុ・ក・ភ・ត・្・ត
អាគន្តុកភិក្ខុ	អាគន្តុក|ភិក្ខុ	អ・ា・គ・ន・្・ត・ុ・ក・ភ・ិ・ក・្・ខ・ុ
អាគន្តុកវត្ត	អាគន្តុក|វត្ត	អ・ា・គ・ន・្・ត・ុ・ក・វ・ត・្・ត
អាគន្តុកា	អាគន្តុកា	អ・ា・គ・ន・្・ត・ុ・ក・ា
អាគន្តុកៈ	អាគន្តុកៈ	អ・ា・គ・ន・្・ត・ុ・ក・ៈ
អាគន្តុក—	អាគន្តុក—	អ・ា・គ・ន・្・ត・ុ・ក・—
អាមន្តន	អា|មន្តន	អ・ា・ម・ន・្・ត・ន
អាមន្តនកថា	អា|មន្ត|នក|ថា	អ・ា・ម・ន・្・ត・ន・ក・ថ・ា
អាមន្តនកិច្ច	អា|មន្តន|កិច្ច	អ・ា・ម・ន・្・ត・ន・ក・ិ・ច・្・ច
អាមន្តនបណ្ណ	អា|មន្តន|បណ្ណ	អ・ា・ម・ន・្・ត・ន・ប・ណ・្・ណ
អាមន្តនបត្រ	អា|មន្ត|នបត្រ	អ・ា・ម・ន・្・ត・ន・ប・ត・្・រ
អាមន្តនភាព	អា|មន្តន|ភាព	អ・ា・ម・ន・្・ត・ន・ភ・ា・ព
អាមន្តនៈ	អា|មន្តនៈ	អ・ា・ម・ន・្・ត・ន・ៈ
អាមន្តន—	អា|មន្ត|ន—	អ・ា・ម・ន・្・ត・ន・—
អាយស្មន្ត	អាយ|ស្មន្ត	អ・ា・យ・ស・្・ម・ន・្・ត
អាយាមន្តរ	អាយា|មន្តរ	អ・ា・យ・ា・ម・ន・្・ត・រ
អាយុស្មន្ត	អាយុ|ស្មន្ត	អ・ា・យ・ុ・ស・្・ម・ន・្・ត
អារោហន្ត	អារោហន្ត	អ・ា・រ・ោ・ហ・ន・្・ត
អាសនន្តរិក	អាសនន្តរិក	អ・ា・ស・ន・ន・្・ត・រ・ិ・ក
អុកអន្តរជាតិ	អុក|អន្តរ|ជាតិ	អ・ុ・ក・អ・ន・្・ត・រ・ជ・ា・ត・ិ
ឥណវន្ត	ឥណ|វន្ត	ឥ・ណ・វ・ន・្・ត
ឥណវន្តី	ឥណ|វន្តី	ឥ・ណ・វ・ន・្・ត・ី
ឥត្ថីមន្ត	ឥត្ថី|មន្ត	ឥ・ត・្・ថ・ី・ម・ន・្・ត
ឥទ្ធិមន្ត	ឥទ្ធិ|មន្ត	ឥ・ទ・្・ធ・ិ・ម・ន・្・ត
ឥទ្ធិមន្តី	ឥទ្ធិ|មន្តី	ឥ・ទ・្・ធ・ិ・ម・ន・្・ត・ី
ឧជុសន្តាន	ឧជុសន្តាន	ឧ・ជ・ុ・ស・ន・្・ត・ា・ន
ឧដ្ឋានវន្ត	ឧដ្ឋាន|វន្ត	ឧ・ដ・្・ឋ・ា・ន・វ・ន・្・ត
ឧដ្ឋានវន្តី	ឧដ្ឋាន|វន្តី	ឧ・ដ・្・ឋ・ា・ន・វ・ន・្・ត・ី
ឧត្តមមន្ត្រី	ឧត្តម|មន្ត្រី	ឧ・ត・្・ត・ម・ម・ន・្・ត・្・រ・ី
ឧត្តានចិន្តា	ឧត្តាន|ចិន្តា	ឧ・ត・្・ត・ា・ន・ច・ិ・ន・្・ត・ា
ឧទកន្តរណ៍	ឧទកន្តរណ៍	ឧ・ទ・ក・ន・្・ត・រ・ណ・៍
ឧទកបរិយន្ត	ឧទកបរិយន្ត	ឧ・ទ・ក・ប・រ・ិ・យ・ន・្・ត
ឧបទ្ទវន្តរាយ	ឧបទ្ទ|វន្តរាយ	ឧ・ប・ទ・្・ទ・វ・ន・្・ត・រ・ា・យ
ឧបនិមន្តន៍	ឧបនិមន្តន៍	ឧ・ប・ន・ិ・ម・ន・្・ត・ន・៍
ឧបវាទន្តរាយ	ឧបវា|ទន្តរាយ	ឧ・ប・វ・ា・ទ・ន・្・ត・រ・ា・យ
ឧបសន្តិភាព	ឧបសន្តិភាព	ឧ・ប・ស・ន・្・ត・ិ・ភ・ា・ព
ឧបសម្បទន្តេវាសិក	ឧបសម្បទ|ន្តេវាសិក	ឧ・ប・ស・ម・្・ប・ទ・ន・្・ត・េ・វ・ា・ស・ិ・ក
ឩសវន្ត	ឩសវន្ត	ឩ・ស・វ・ន・្・ត
ឯកន្តបរមសុខ	ឯកន្ត|បរម|សុខ	ឯ・ក・ន・្・ត・ប・រ・ម・ស・ុ・ខ
ឯកន្តសុខ	ឯកន្ត|សុខ	ឯ・ក・ន・្・ត・ស・ុ・ខ
ឯកអគ្គារហន្ត	ឯក|អគ្គារ|ហន្ត	ឯ・ក・អ・គ・្・គ・ា・រ・ហ・ន・្・ត
ឱជវន្តី	ឱជវន្តី	ឱ・ជ・វ・ន・្・ត・ី
ឱជវ័ន្ត	ឱជវ័ន្ត	ឱ・ជ・វ・័・ន・្・ត
ឱតភ័ន្ត	ឱត|ភ័ន្ត	ឱ・ត・ភ・័・ន・្・ត
ឱភាសមន្ត្រី	ឱភាស|មន្ត្រី	ឱ・ភ・ា・ស・ម・ន・្・ត・្・រ・ី
