កក់ក្ដៅ	កក់ក្ដៅ	ក・ក・់・ក・្・ដ・ៅ
កាកល័ក្ដ	កាកល័ក្ដ	ក・ា・ក・ល・័・ក・្・ដ
កាត់ក្ដី	កាត់|ក្ដី	ក・ា・ត・់・ក・្・ដ・ី
កាំជ្រួចទឹកក្ដៅ	កាំ|ជ្រួច|ទឹក|ក្ដៅ	ក・ា・ំ・ជ・្・រ・ួ・ច・ទ・ឹ・ក・ក・្・ដ・ៅ
កើតក្ដី	កើត|ក្ដី	ក・ើ・ត・ក・្・ដ・ី
ក្ដ	ក្ដ	ក・្・ដ
ក្ដក់	ក្ដក់	ក・្・ដ・ក・់
ក្ដន់	ក្ដន់	ក・្・ដ・ន・់
ក្ដាត	ក្ដាត	ក・្・ដ・ា・ត
ក្ដាត់	ក្ដាត់	ក・្・ដ・ា・ត・់
ក្ដាន់	ក្ដាន់	ក・្・ដ・ា・ន・់
ក្ដាប់	ក្ដាប់	ក・្・ដ・ា・ប・់
ក្ដាម	ក្ដាម	ក・្・ដ・ា・ម
ក្ដាមកាច់	ក្ដាម|កាច់	ក・្・ដ・ា・ម・ក・ា・ច・់
ក្ដាមទូក	ក្ដាម|ទូក	ក・្・ដ・ា・ម・ទ・ូ・ក
ក្ដារ	ក្ដារ	ក・្・ដ・ា・រ
ក្ដារខៀន	ក្ដារ|ខៀន	ក・្・ដ・ា・រ・ខ・ៀ・ន
ក្ដារចុច	ក្ដារ|ចុច	ក・្・ដ・ា・រ・ច・ុ・ច
ក្ដារឆ្នួន	ក្ដារ|ឆ្នួន	ក・្・ដ・ា・រ・ឆ・្・ន・ួ・ន
ក្ដារបន្ទះ	ក្ដារ|បន្ទះ	ក・្・ដ・ា・រ・ប・ន・្・ទ・ះ
ក្ដារពុម្ព	ក្ដារ|ពុម្ព	ក・្・ដ・ា・រ・ព・ុ・ម・្・ព
ក្ដារអុក	ក្ដារ|អុក	ក・្・ដ・ា・រ・អ・ុ・ក
ក្ដាំ	ក្ដាំ	ក・្・ដ・ា・ំ
ក្ដាំង	ក្ដាំង	ក・្・ដ・ា・ំ・ង
ក្ដាំងងា	ក្ដាំង|ងា	ក・្・ដ・ា・ំ・ង・ង・ា
ក្ដាំងបាយ	ក្ដាំង|បាយ	ក・្・ដ・ា・ំ・ង・ប・ា・យ
ក្ដិច	ក្ដិច	ក・្・ដ・ិ・ច
ក្ដិចសង្អារបញ្ជល់	ក្ដិច|សង្អារ|បញ្ជល់	ក・្・ដ・ិ・ច・ស・ង・្・អ・ា・រ・ប・ញ・្・ជ・ល・់
ក្ដិត	ក្ដិត	ក・្・ដ・ិ・ត
ក្ដី	ក្ដី	ក・្・ដ・ី
ក្ដីក្ដាំ	ក្ដី|ក្ដាំ	ក・្・ដ・ី・ក・្・ដ・ា・ំ
ក្ដីក្ដាំ	ក្ដី|ក្ដាំ	ក・្・ដ・ី・ក・្・ដ・ា・ំ
ក្ដីណា	ក្ដី|ណា	ក・្・ដ・ី・ណ・ា
ក្ដីរំពឹងទុក	ក្ដី|រំពឹង|ទុក	ក・្・ដ・ី・រ・ំ・ព・ឹ・ង・ទ・ុ・ក
ក្ដីសង្ឃឹម	ក្ដី|សង្ឃឹម	ក・្・ដ・ី・ស・ង・្・ឃ・ឹ・ម
ក្ដឹប	ក្ដឹប	ក・្・ដ・ឹ・ប
ក្ដឹះ	ក្ដឹះ	ក・្・ដ・ឹ・ះ
ក្ដុក	ក្ដុក	ក・្・ដ・ុ・ក
ក្ដុកៗ	ក្ដុក|ៗ	ក・្・ដ・ុ・ក・ៗ
ក្ដុង	ក្ដុង	ក・្・ដ・ុ・ង
ក្ដុងក្ដាំង	ក្ដុង|ក្ដាំង	ក・្・ដ・ុ・ង・ក・្・ដ・ា・ំ・ង
ក្ដុងក្ដាំង	ក្ដុង|ក្ដាំង	ក・្・ដ・ុ・ង・ក・្・ដ・ា・ំ・ង
ក្ដុល	ក្ដុល	ក・្・ដ・ុ・ល
ក្ដូនចេស	ក្ដូន|ចេស	ក・្・ដ・ូ・ន・ច・េ・ស
ក្ដួច	ក្ដួច	ក・្・ដ・ួ・ច
ក្ដួល	ក្ដួល	ក・្・ដ・ួ・ល
ក្ដឿង	ក្ដឿង	ក・្・ដ・ឿ・ង
ក្ដៀង	ក្ដៀង	ក・្・ដ・ៀ・ង
ក្ដៀន	ក្ដៀន	ក・្・ដ・ៀ・ន
ក្ដៀប	ក្ដៀប	ក・្・ដ・ៀ・ប
ក្ដែងៗ	ក្ដែង|ៗ	ក・្・ដ・ែ・ង・ៗ
ក្ដោង	ក្ដោង	ក・្・ដ・ោ・ង
ក្ដោប	ក្ដោប	ក・្・ដ・ោ・ប
ក្ដោបក្ដាប់	ក្ដោប|ក្ដាប់	ក・្・ដ・ោ・ប・ក・្・ដ・ា・ប・់
ក្ដោបក្ដាប់	ក្ដោប|ក្ដាប់	ក・្・ដ・ោ・ប・ក・្・ដ・ា・ប・់
ក្ដោបអំណាច	ក្ដោប|អំណាច	ក・្・ដ・ោ・ប・អ・ំ・ណ・ា・ច
ក្ដៅ	ក្ដៅ	ក・្・ដ・ៅ
ក្ដៅក្រហាយ	ក្ដៅ|ក្រហាយ	ក・្・ដ・ៅ・ក・្・រ・ហ・ា・យ
ក្ដៅខ្លួន	ក្ដៅ|ខ្លួន	ក・្・ដ・ៅ・ខ・្・ល・ួ・ន
ក្ដៅងំ	ក្ដៅ|ងំ	ក・្・ដ・ៅ・ង・ំ
ក្ដៅចិត្ត	ក្ដៅ|ចិត្ត	ក・្・ដ・ៅ・ច・ិ・ត・្・ត
ក្ដៅសាច់	ក្ដៅ|សាច់	ក・្・ដ・ៅ・ស・ា・ច・់
ក្ដៅស្លឹកត្រចៀក	ក្ដៅ|ស្លឹក|ត្រចៀក	ក・្・ដ・ៅ・ស・្・ល・ឹ・ក・ត・្・រ・ច・ៀ・ក
ក្ដៅស្អុះ	ក្ដៅ|ស្អុះ	ក・្・ដ・ៅ・ស・្・អ・ុ・ះ
ខាត់ណាក្ដោប	ខាត់|ណា|ក្ដោប	ខ・ា・ត・់・ណ・ា・ក・្・ដ・ោ・ប
ខៃសេចក្ដី	ខៃ|សេចក្ដី	ខ・ៃ・ស・េ・ច・ក・្・ដ・ី
គជមុក្ដា	គជមុក្ដា	គ・ជ・ម・ុ・ក・្・ដ・ា
គារវភក្ដី	គារវភក្ដី	គ・ា・រ・វ・ភ・ក・្・ដ・ី
គូក្ដី	គូ|ក្ដី	គ・ូ・ក・្・ដ・ី
ចងល័ក្ដ	ចង|ល័ក្ដ	ច・ង・ល・័・ក・្・ដ
ឆាក្ដៅ	ឆា|ក្ដៅ	ឆ・ា・ក・្・ដ・ៅ
ជម្រះក្ដី	ជម្រះ|ក្ដី	ជ・ម・្・រ・ះ・ក・្・ដ・ី
ជាប់ក្ដី	ជាប់|ក្ដី	ជ・ា・ប・់・ក・្・ដ・ី
ញាតិភក្ដិ	ញាតិ|ភក្ដិ	ញ・ា・ត・ិ・ភ・ក・្・ដ・ិ
ដងក្ដារ	ដង|ក្ដារ	ដ・ង・ក・្・ដ・ា・រ
ដឹងក្ដី	ដឹង|ក្ដី	ដ・ឹ・ង・ក・្・ដ・ី
ឋានន្តរសក្ដិ	ឋានន្តរ|សក្ដិ	ឋ・ា・ន・ន・្・ត・រ・ស・ក・្・ដ・ិ
តង្កៀបក្ដាម	តង្កៀប|ក្ដាម	ត・ង・្・ក・ៀ・ប・ក・្・ដ・ា・ម
តែងសេចក្ដីរុំៗ	តែង|សេចក្ដី|រុំ|ៗ	ត・ែ・ង・ស・េ・ច・ក・្・ដ・ី・រ・ុ・ំ・ៗ
ត្រដោកក្ដារ	ត្រដោក|ក្ដារ	ត・្・រ・ដ・ោ・ក・ក・្・ដ・ា・រ
ថណាយក្ដី	ថណាយ|ក្ដី	ថ・ណ・ា・យ・ក・្・ដ・ី
ថ្ដោកក្ដារ	ថ្ដោក|ក្ដារ	ថ・្・ដ・ោ・ក・ក・្・ដ・ា・រ
ទម្រង់ស័ក្ដិ	ទម្រង់|ស័ក្ដិ	ទ・ម・្・រ・ង・់・ស・័・ក・្・ដ・ិ
ធ្លាក់ថ្លើមក្ដុក	ធ្លាក់|ថ្លើម|ក្ដុក	ធ・្・ល・ា・ក・់・ថ・្・ល・ើ・ម・ក・្・ដ・ុ・ក
ធ្វើធ្មេញលេញល័ក្ដ	ធ្វើ|ធ្មេញ|លេញ|ល័ក្ដ	ធ・្・វ・ើ・ធ・្・ម・េ・ញ・ល・េ・ញ・ល・័・ក・្・ដ
នៅក្ដី	នៅ|ក្ដី	ន・ៅ・ក・្・ដ・ី
បណ្ដាស័ក្ដិ	បណ្ដា|ស័ក្ដិ	ប・ណ・្・ដ・ា・ស・័・ក・្・ដ・ិ
បន្ទាយក្ដី	បន្ទាយ|ក្ដី	ប・ន・្・ទ・ា・យ・ក・្・ដ・ី
បន្ទំល័ក្ដ	បន្ទំល័ក្ដ	ប・ន・្・ទ・ំ・ល・័・ក・្・ដ
បរិភោក្ដា	បរិភោក្ដា	ប・រ・ិ・ភ・ោ・ក・្・ដ・ា
បាយក្ដាំង	បាយ|ក្ដាំង	ប・ា・យ・ក・្・ដ・ា・ំ・ង
បាយក្ដាំងគំទឹក	បាយ|ក្ដាំង|គំ|ទឹក	ប・ា・យ・ក・្・ដ・ា・ំ・ង・គ・ំ・ទ・ឹ・ក
បុកល័ក្ដ	បុក|ល័ក្ដ	ប・ុ・ក・ល・័・ក・្・ដ
បុណ្យស័ក្ដិ	បុណ្យ|ស័ក្ដិ	ប・ុ・ណ・្・យ・ស・័・ក・្・ដ・ិ
បើកក្ដោង	បើក|ក្ដោង	ប・ើ・ក・ក・្・ដ・ោ・ង
បៀមពាក្យបៀមសេចក្ដី	បៀម|ពាក្យ|បៀម|សេចក្ដី	ប・ៀ・ម・ព・ា・ក・្・យ・ប・ៀ・ម・ស・េ・ច・ក・្・ដ・ី
ប៉ានសក្ដិ	ប៉ាន|សក្ដិ	ប・៉・ា・ន・ស・ក・្・ដ・ិ
ប្រកាសសេចក្ដី	ប្រកាស|សេចក្ដី	ប・្・រ・ក・ា・ស・ស・េ・ច・ក・្・ដ・ី
ប្រធានសក្ដិ	ប្រធាន|សក្ដិ	ប・្・រ・ធ・ា・ន・ស・ក・្・ដ・ិ
ប្រែរៀងសេចក្ដី	ប្រែ|រៀង|សេចក្ដី	ប・្・រ・ែ・រ・ៀ・ង・ស・េ・ច・ក・្・ដ・ី
ផែនក្ដារ	ផែនក្ដារ	ផ・ែ・ន・ក・្・ដ・ា・រ
ផ្គរផ្ដាំក្ដាមខ្យង	ផ្គរ|ផ្ដាំ|ក្ដាម|ខ្យង	ផ・្・គ・រ・ផ・្・ដ・ា・ំ・ក・្・ដ・ា・ម・ខ・្・យ・ង
ផ្លូវសេចក្ដី	ផ្លូវ|សេចក្ដី	ផ・្・ល・ូ・វ・ស・េ・ច・ក・្・ដ・ី
ពងក្ដ	ពង|ក្ដ	ព・ង・ក・្・ដ
ពងក្ដ!	ពង|ក្ដ|!	ព・ង・ក・្・ដ・!
ពលសក្ដិ	ពល|សក្ដិ	ព・ល・ស・ក・្・ដ・ិ
ពលស័ក្ដិ	ពល|ស័ក្ដិ	ព・ល・ស・័・ក・្・ដ・ិ
ពហូសក្ដិ	ពហូស|ក្ដិ	ព・ហ・ូ・ស・ក・្・ដ・ិ
ពិភ័ក្ដិ	ពិភ័ក្ដិ	ព・ិ・ភ・័・ក・្・ដ・ិ
ភក្ដិ	ភក្ដិ	ភ・ក・្・ដ・ិ
ភក្ដី	ភក្ដី	ភ・ក・្・ដ・ី
ភក្ដីភាព	ភក្ដី|ភាព	ភ・ក・្・ដ・ី・ភ・ា・ព
ភក្ដីអនុជិត	ភក្ដី|អនុជិត	ភ・ក・្・ដ・ី・អ・ន・ុ・ជ・ិ・ត
ភក្ដ្រ	ភក្ដ្រ	ភ・ក・្・ដ・្・រ
ភោក្ដា	ភោក្ដា	ភ・ោ・ក・្・ដ・ា
ភ័ក្ដិ	ភ័ក្ដិ	ភ・័・ក・្・ដ・ិ
ភ័ក្ដ្រ	ភ័ក្ដ្រ	ភ・័・ក・្・ដ・្・រ
មណ្ឌលអាកាសក្ដៅ	មណ្ឌល|អាកាស|ក្ដៅ	ម・ណ・្・ឌ・ល・អ・ា・ក・ា・ស・ក・្・ដ・ៅ
មិត្រភក្ដិ	មិត្រ|ភក្ដិ	ម・ិ・ត・្・រ・ភ・ក・្・ដ・ិ
មុក្ដា	មុក្ដា	ម・ុ・ក・្・ដ・ា
មុក្ដាហារ	មុក្ដាហារ	ម・ុ・ក・្・ដ・ា・ហ・ា・រ
មូលសេចក្ដី	មូល|សេចក្ដី	ម・ូ・ល・ស・េ・ច・ក・្・ដ・ី
មេល័ក្ដ	មេល័ក្ដ	ម・េ・ល・័・ក・្・ដ
ម៉ាស៊ីនទឹកក្ដៅ	ម៉ាស៊ីន|ទឹក|ក្ដៅ	ម・៉・ា・ស・៊・ី・ន・ទ・ឹ・ក・ក・្・ដ・ៅ
ម្ជុលក្ដោង	ម្ជុល|ក្ដោង	ម・្・ជ・ុ・ល・ក・្・ដ・ោ・ង
ម្ដេចក្ដី	ម្ដេច|ក្ដី	ម・្・ដ・េ・ច・ក・្・ដ・ី
ម្អមក្ដាម	ម្អ|មក្ដាម	ម・្・អ・ម・ក・្・ដ・ា・ម
យកក្ដី	យក|ក្ដី	យ・ក・ក・្・ដ・ី
យសសក្ដិ	យស|សក្ដិ	យ・ស・ស・ក・្・ដ・ិ
យសស័ក្ដិ	យស|ស័ក្ដិ	យ・ស・ស・័・ក・្・ដ・ិ
យោងសេចក្ដី	យោង|សេចក្ដី	យ・ោ・ង・ស・េ・ច・ក・្・ដ・ី
រាជភក្ដី	រាជ|ភក្ដី	រ・ា・ជ・ភ・ក・្・ដ・ី
រាជសក្ដិ	រាជ|សក្ដិ	រ・ា・ជ・ស・ក・្・ដ・ិ
រាជស័ក្ដិ	រាជ|ស័ក្ដិ	រ・ា・ជ・ស・័・ក・្・ដ・ិ
លាយល័ក្ដ	លាយ|ល័ក្ដ	ល・ា・យ・ល・័・ក・្・ដ
លីងល័ក្ដ	លីង|ល័ក្ដ	ល・ី・ង・ល・័・ក・្・ដ
ល័ក្ដ	ល័ក្ដ	ល・័・ក・្・ដ
ល័ក្ដជុំកន្លង់	ល័ក្ដ|ជុំ|កន្លង់	ល・័・ក・្・ដ・ជ・ុ・ំ・ក・ន・្・ល・ង・់
វែកផ្លូវសេចក្ដី	វែក|ផ្លូវ|សេចក្ដី	វ・ែ・ក・ផ・្・ល・ូ・វ・ស・េ・ច・ក・្・ដ・ី
សក្ដា	សក្ដា	ស・ក・្・ដ・ា
សក្ដាតេជ	សក្ដាតេជ	ស・ក・្・ដ・ា・ត・េ・ជ
សក្ដាតេជះ	សក្ដា|តេជះ	ស・ក・្・ដ・ា・ត・េ・ជ・ះ
សក្ដានុភាព	សក្ដានុភាព	ស・ក・្・ដ・ា・ន・ុ・ភ・ា・ព
សក្ដិ	សក្ដិ	ស・ក・្・ដ・ិ
សក្ដិត្រ័យ	សក្ដិត្រ័យ	ស・ក・្・ដ・ិ・ត・្・រ・័・យ
សក្ដិធរ	សក្ដិធរ	ស・ក・្・ដ・ិ・ធ・រ
សក្ដិភូមិ	សក្ដិ|ភូមិ	ស・ក・្・ដ・ិ・ភ・ូ・ម・ិ
សមណសក្ដិ	សមណ|សក្ដិ	ស・ម・ណ・ស・ក・្・ដ・ិ
សមណសក្ដិទីរាជាគណៈខាងគណៈធម្មយុត្តិកនិកាយ	សមណ|សក្ដិ|ទី|រាជា|គណៈ|ខាង|គណៈ|ធម្ម|យុត្តិក|និកាយ	ស・ម・ណ・ស・ក・្・ដ・ិ・ទ・ី・រ・ា・ជ・ា・គ・ណ・ៈ・ខ・ា・ង・គ・ណ・ៈ・ធ・ម・្・ម・យ・ុ・ត・្・ត・ិ・ក・ន・ិ・ក・ា・យ
សមណសក្ដិទីរាជាគណៈខាងគណៈមហានិកាយ	សមណ|សក្ដិ|ទី|រាជា|គណៈ|ខាង|គណៈ|មហា|និកាយ	ស・ម・ណ・ស・ក・្・ដ・ិ・ទ・ី・រ・ា・ជ・ា・គ・ណ・ៈ・ខ・ា・ង・គ・ណ・ៈ・ម・ហ・ា・ន・ិ・ក・ា・យ
សមណស័ក្ដិ	សមណ|ស័ក្ដិ	ស・ម・ណ・ស・័・ក・្・ដ・ិ
សមណស័ក្ដិទីរាជាគណៈសម្រាប់ត្រី	សមណ|ស័ក្ដិ|ទី|រាជា|គណៈ|សម្រាប់|ត្រី	ស・ម・ណ・ស・័・ក・្・ដ・ិ・ទ・ី・រ・ា・ជ・ា・គ・ណ・ៈ・ស・ម・្・រ・ា・ប・់・ត・្・រ・ី
សមណស័ក្ដិទីរាជាគណៈសម្រាប់ទោ	សមណ|ស័ក្ដិ|ទី|រាជា|គណៈ|សម្រាប់|ទោ	ស・ម・ណ・ស・័・ក・្・ដ・ិ・ទ・ី・រ・ា・ជ・ា・គ・ណ・ៈ・ស・ម・្・រ・ា・ប・់・ទ・ោ
សមណស័ក្ដិទីរាជាគណៈសម្រាប់ឯក	សមណ|ស័ក្ដិ|ទី|រាជា|គណៈ|សម្រាប់|ឯក	ស・ម・ណ・ស・័・ក・្・ដ・ិ・ទ・ី・រ・ា・ជ・ា・គ・ណ・ៈ・ស・ម・្・រ・ា・ប・់・ឯ・ក
សមណស័ក្ដិរាជាគណៈសម្រាប់ចត្វា	សមណ|ស័ក្ដិ|រាជា|គណៈ|សម្រាប់|ចត្វា	ស・ម・ណ・ស・័・ក・្・ដ・ិ・រ・ា・ជ・ា・គ・ណ・ៈ・ស・ម・្・រ・ា・ប・់・ច・ត・្・វ・ា
សមសក្ដានុភូត	សម|សក្ដានុភូត	ស・ម・ស・ក・្・ដ・ា・ន・ុ・ភ・ូ・ត
សមសក្ដិ	សម|សក្ដិ	ស・ម・ស・ក・្・ដ・ិ
សមស័ក្ដិ	សមស័ក្ដិ	ស・ម・ស・័・ក・្・ដ・ិ
សាពិភ័ក្ដិ	សាពិភ័ក្ដិ	ស・ា・ព・ិ・ភ・័・ក・្・ដ・ិ
សាមីភ័ក្ដិ	សាមីភ័ក្ដិ	ស・ា・ម・ី・ភ・័・ក・្・ដ・ិ
សាលាជម្រះក្ដី	សាលា|ជម្រះ|ក្ដី	ស・ា・ល・ា・ជ・ម・្・រ・ះ・ក・្・ដ・ី
សាលាដក្ដោប	សាលាដ|ក្ដោប	ស・ា・ល・ា・ដ・ក・្・ដ・ោ・ប
សាឡាត់ក្ដោប	សាឡាត់|ក្ដោប	ស・ា・ឡ・ា・ត・់・ក・្・ដ・ោ・ប
សិទ្ធិស័ក្ដិ	សិទ្ធិ|ស័ក្ដិ	ស・ិ・ទ・្・ធ・ិ・ស・័・ក・្・ដ・ិ
សុយម៉េៈក្ដាមប្រៃ	សុយ|ម៉េៈ|ក្ដាម|ប្រៃ	ស・ុ・យ・ម・៉・េ・ៈ・ក・្・ដ・ា・ម・ប・្・រ・ៃ
សេចក្ដាំ	សេចក្ដាំ	ស・េ・ច・ក・្・ដ・ា・ំ
សេចក្ដី	សេចក្ដី	ស・េ・ច・ក・្・ដ・ី
សេចក្ដីថ្លែងការណ៍	សេចក្ដី|ថ្លែង|ការណ៍	ស・េ・ច・ក・្・ដ・ី・ថ・្・ល・ែ・ង・ក・ា・រ・ណ・៍
សេចក្ដីប្រកាសព័ត៌មាន	សេចក្ដី|ប្រកាស|ព័ត៌មាន	ស・េ・ច・ក・្・ដ・ី・ប・្・រ・ក・ា・ស・ព・័・ត・៌・ម・ា・ន
សេចក្ដីព្រាងច្បាប់	សេចក្ដី|ព្រាង|ច្បាប់	ស・េ・ច・ក・្・ដ・ី・ព・្・រ・ា・ង・ច・្・ប・ា・ប・់
សេចក្ដីយ៉	សេចក្ដី|យ៉	ស・េ・ច・ក・្・ដ・ី・យ・៉
សេចក្ដីរាក់	សេចក្ដី|រាក់	ស・េ・ច・ក・្・ដ・ី・រ・ា・ក・់
សេចក្ដីសម្រេច	សេចក្ដី|សម្រេច	ស・េ・ច・ក・្・ដ・ី・ស・ម・្・រ・េ・ច
សេចក្ដីស្នើច្បាប់	សេចក្ដី|ស្នើ|ច្បាប់	ស・េ・ច・ក・្・ដ・ី・ស・្・ន・ើ・ច・្・ប・ា・ប・់
ស័ក្ដិ	ស័ក្ដិ	ស・័・ក・្・ដ・ិ
ស័ក្ដិយស	ស័ក្ដិយស	ស・័・ក・្・ដ・ិ・យ・ស
ស័ក្ដិសម	ស័ក្ដិសម	ស・័・ក・្・ដ・ិ・ស・ម
ស័ក្ដិសិទ្ធិ	ស័ក្ដិសិទ្ធិ	ស・័・ក・្・ដ・ិ・ស・ិ・ទ・្・ធ・ិ
ស័ក្ដិ៩ហ៊ូពាន់	ស័ក្ដិ៩|ហ៊ូ|ពាន់	ស・័・ក・្・ដ・ិ・៩・ហ・៊・ូ・ព・ា・ន・់
ស្ពៃក្ដោប	ស្ពៃ|ក្ដោប	ស・្・ព・ៃ・ក・្・ដ・ោ・ប
ស្មាក្ដី	ស្មា|ក្ដី	ស・្・ម・ា・ក・្・ដ・ី
ស្រកាក្ដាម	ស្រកា|ក្ដាម	ស・្・រ・ក・ា・ក・្・ដ・ា・ម
ស្រពព្រះភក្ដ្រ	ស្រព|ព្រះ|ភក្ដ្រ	ស・្・រ・ព・ព・្・រ・ះ・ភ・ក・្・ដ・្・រ
ស្រមណសក្ដិ	ស្រមណ|សក្ដិ	ស・្・រ・ម・ណ・ស・ក・្・ដ・ិ
ស្រមណស័ក្ដិ	ស្រមណ|ស័ក្ដិ	ស・្・រ・ម・ណ・ស・័・ក・្・ដ・ិ
ស្រែកបែកក្ដឹះ	ស្រែក|បែក|ក្ដឹះ	ស・្・រ・ែ・ក・ប・ែ・ក・ក・្・ដ・ឹ・ះ
ស្វទេសភក្ដី	ស្វ|ទេស|ភក្ដី	ស・្・វ・ទ・េ・ស・ភ・ក・្・ដ・ី
ស្វទេសភ័ក្ដ	ស្វ|ទេសភ័ក្ដ	ស・្・វ・ទ・េ・ស・ភ・័・ក・្・ដ
ស្វាមីភក្ដិ	ស្វាមី|ភក្ដិ	ស・្・វ・ា・ម・ី・ភ・ក・្・ដ・ិ
ស្វាមីភ័ក្ដិ	ស្វាមី|ភ័ក្ដិ	ស・្・វ・ា・ម・ី・ភ・័・ក・្・ដ・ិ
ឡើងបុណ្យស័ក្ដិ	ឡើង|បុណ្យ|ស័ក្ដិ	ឡ・ើ・ង・ប・ុ・ណ・្・យ・ស・័・ក・្・ដ・ិ
ឡើងបុណ្យឡើងស័ក្ដិ	ឡើង|បុណ្យ|ឡើង|ស័ក្ដិ	ឡ・ើ・ង・ប・ុ・ណ・្・យ・ឡ・ើ・ង・ស・័・ក・្・ដ・ិ
អគ្គស្មាក្ដី	អគ្គ|ស្មា|ក្ដី	អ・គ・្・គ・ស・្・ម・ា・ក・្・ដ・ី
អង្គសេចក្ដី	អង្គ|សេចក្ដី	អ・ង・្・គ・ស・េ・ច・ក・្・ដ・ី
អង្គឺក្ដី	អង្គឺ|ក្ដី	អ・ង・្・គ・ឺ・ក・្・ដ・ី
អតិភោក្ដា	អតិភោក្ដា	អ・ត・ិ・ភ・ោ・ក・្・ដ・ា
អនុរក្ដិ	អនុ|រក្ដិ	អ・ន・ុ・រ・ក・្・ដ・ិ
អបសក្ដិ	អបសក្ដិ	អ・ប・ស・ក・្・ដ・ិ
អបស័ក្ដិ	អបស័ក្ដិ	អ・ប・ស・័・ក・្・ដ・ិ
អប្បសក្ដិ	អប្បសក្ដិ	អ・ប・្・ប・ស・ក・្・ដ・ិ
អប្បស័ក្ដិ	អប្បស័ក្ដិ	អ・ប・្・ប・ស・័・ក・្・ដ・ិ
អាចក្ដី	អាច|ក្ដី	អ・ា・ច・ក・្・ដ・ី
អាចម៍ល័ក្ដ	អាចម៍|ល័ក្ដ	អ・ា・ច・ម・៍・ល・័・ក・្・ដ
អុតក្ដាម	អុត|ក្ដាម	អ・ុ・ត・ក・្・ដ・ា・ម
ឥស្សរិយស័ក្ដិ	ឥស្សរិយ|ស័ក្ដិ	ឥ・ស・្・ស・រ・ិ・យ・ស・័・ក・្・ដ・ិ
ឧត្តមស័ក្ដិ	ឧត្តម|ស័ក្ដិ	ឧ・ត・្・ត・ម・ស・័・ក・្・ដ・ិ
ឯកភក្ដិ	ឯក|ភក្ដិ	ឯ・ក・ភ・ក・្・ដ・ិ
ឯកភក្ដី	ឯក|ភក្ដី	ឯ・ក・ភ・ក・្・ដ・ី
ឯកភ័ក្ដិ	ឯក|ភ័ក្ដិ	ឯ・ក・ភ・័・ក・្・ដ・ិ
ឯកស័ក្ដិ	ឯកស័ក្ដិ	ឯ・ក・ស・័・ក・្・ដ・ិ
ឰកស័ក្ដិ	ឰក|ស័ក្ដិ	ឰ・ក・ស・័・ក・្・ដ・ិ
ឱ្យកូនទៅនៅក្ដី	ឱ្យ|កូន|ទៅ|នៅ|ក្ដី	ឱ・្・យ・ក・ូ・ន・ទ・ៅ・ន・ៅ・ក・្・ដ・ី
