កករចិត្ត	ក・ក・រ・ច・ិ・ត・្・ត
កញ្ញាកិត្តិយស	ក・ញ・្・ញ・ា・ក・ិ・ត・្・ត・ិ・យ・ស
ធ្ងន់ចិត្តកណ្ដុក	ធ・្・ង・ន・់・ច・ិ・ត・្・ត・ក・ណ・្・ដ・ុ・ក
កត្តា	ក・ត・្・ត・ា
កត្តា	ក・ត・្・ត・ា
កត្តិក	ក・ត・្・ត・ិ・ក
កត្តុវាចក	ក・ត・្・ត・ុ・វ・ា・ច・ក
កត្តុវាចកៈ	ក・ត・្・ត・ុ・វ・ា・ច・ក・ៈ
កបិចិត្ត	ក・ប・ិ・ច・ិ・ត・្・ត
កម្មសិទ្ធិឯកត្តជន	ក・ម・្・ម・ស・ិ・ទ・្・ធ・ិ・ឯ・ក・ត・្・ត・ជ・ន
កម្លាចិត្ត	ក・ម・្・ល・ា・ច・ិ・ត・្・ត
កម្លាំងចិត្ត	ក・ម・្・ល・ា・ំ・ង・ច・ិ・ត・្・ត
ក័លក័ត្តា	ក・័・ល・ក・័・ត・្・ត・ា
កល្យាណមិត្ត	ក・ល・្・យ・ា・ណ・ម・ិ・ត・្・ត
កាត់ចិត្តកាត់ថ្លើម	ក・ា・ត・់・ច・ិ・ត・្・ត・ក・ា・ត・់・ថ・្・ល・ើ・ម
កាមុម្មត្តកៈ	ក・ា・ម・ុ・ម・្・ម・ត・្・ត・ក・ៈ
កាយវិញ្ញត្តិ	ក・ា・យ・វ・ិ・ញ・្・ញ・ត・្・ត・ិ
ការុញ្ញចិត្ត	ក・ា・រ・ុ・ញ・្・ញ・ច・ិ・ត・្・ត
កាលវិបត្តិ	ក・ា・ល・វ・ិ・ប・ត・្・ត・ិ
កាលសម្បត្តិ	ក・ា・ល・ស・ម・្・ប・ត・្・ត・ិ
កាលប្បវត្តិ	ក・ា・ល・ប・្・ប・វ・ត・្・ត・ិ
កាលប្រវត្តិ	ក・ា・ល・ប・្・រ・វ・ត・្・ត・ិ
កាលប្រវត្តិវិទ្យា	ក・ា・ល・ប・្・រ・វ・ត・្・ត・ិ・វ・ិ・ទ・្・យ・ា
កាលសម័យបុរេប្រវត្តិ	ក・ា・ល・ស・ម・័・យ・ប・ុ・រ・េ・ប・្・រ・វ・ត・្・ត・ិ
កាលសម័យប្រវត្តិសាស្ត្រ	ក・ា・ល・ស・ម・័・យ・ប・្・រ・វ・ត・្・ត・ិ・ស・ា・ស・្・ត・្・រ
កាលានុវត្តនិយម	ក・ា・ល・ា・ន・ុ・វ・ត・្・ត・ន・ិ・យ・ម
កាលានុវត្តភាព	ក・ា・ល・ា・ន・ុ・វ・ត・្・ត・ភ・ា・ព
កិត្តិ	ក・ិ・ត・្・ត・ិ
កិត្តិគុណ	ក・ិ・ត・្・ត・ិ・គ・ុ・ណ
កិត្តិនាម	ក・ិ・ត・្・ត・ិ・ន・ា・ម
កិត្តិយស	ក・ិ・ត・្・ត・ិ・យ・ស
កិត្តិសព្ទ	ក・ិ・ត・្・ត・ិ・ស・ព・្・ទ
កីឡាអត្តពលកម្ម	ក・ី・ឡ・ា・អ・ត・្・ត・ព・ល・ក・ម・្・ម
កុដិកភត្ត	ក・ុ・ដ・ិ・ក・ភ・ត・្・ត
កុលវិបត្តិ	ក・ុ・ល・វ・ិ・ប・ត・្・ត・ិ
កុលសម្បត្តិ	ក・ុ・ល・ស・ម・្・ប・ត・្・ត・ិ
ក្ដៅចិត្ត	ក・្・ដ・ៅ・ច・ិ・ត・្・ត
ក្រំចិត្ត	ក・្・រ・ំ・ច・ិ・ត・្・ត
ខកចិត្ត	ខ・ក・ច・ិ・ត・្・ត
ខត្តិយៈ	ខ・ត・្・ត・ិ・យ・ៈ
ខលុបច្ឆាភត្តិកង្គ	ខ・ល・ុ・ប・ច・្・ឆ・ា・ភ・ត・្・ត・ិ・ក・ង・្・គ
ខិត្តប័ណ្ណ	ខ・ិ・ត・្・ត・ប・័・ណ・្・ណ
ខូចចិត្ត	ខ・ូ・ច・ច・ិ・ត・្・ត
ខេត្ត	ខ・េ・ត・្・ត
ខេត្តុបករណ៍	ខ・េ・ត・្・ត・ុ・ប・ក・រ・ណ・៍
ខ្លាចចិត្ត	ខ・្・ល・ា・ច・ច・ិ・ត・្・ត
គតិបណ្ឌិតប្រតិបត្តិ	គ・ត・ិ・ប・ណ・្・ឌ・ិ・ត・ប・្・រ・ត・ិ・ប・ត・្・ត・ិ
គតិយុត្ត	គ・ត・ិ・យ・ុ・ត・្・ត
គតិយុត្តិ	គ・ត・ិ・យ・ុ・ត・្・ត・ិ
គិលានភត្ត	គ・ិ・ល・ា・ន・ភ・ត・្・ត
គុណវិបត្តិ	គ・ុ・ណ・វ・ិ・ប・ត・្・ត・ិ
គុណសម្បត្តិ	គ・ុ・ណ・ស・ម・្・ប・ត・្・ត・ិ
គោតមគោត្ត	គ・ោ・ត・ម・គ・ោ・ត・្・ត
គោត្ត	គ・ោ・ត・្・ត
គោត្តនាម	គ・ោ・ត・្・ត・ន・ា・ម
គោវត្ត	គ・ោ・វ・ត・្・ត
ឃោសាឃោសវិមុត្ត	ឃ・ោ・ស・ា・ឃ・ោ・ស・វ・ិ・ម・ុ・ត・្・ត
ងាកចិត្ត	ង・ា・ក・ច・ិ・ត・្・ត
ចក្ខុនិមិត្ត	ច・ក・្・ខ・ុ・ន・ិ・ម・ិ・ត・្・ត
ចក្រពត្តិ	ច・ក・្・រ・ព・ត・្・ត・ិ
ចក្រពត្តិនិយម	ច・ក・្・រ・ព・ត・្・ត・ិ・ន・ិ・យ・ម
ចងចិត្ត	ច・ង・ច・ិ・ត・្・ត
ចត្តាឡីស័ក	ច・ត・្・ត・ា・ឡ・ី・ស・័・ក
ចាប់ចិត្ត	ច・ា・ប・់・ច・ិ・ត・្・ត
ចាលចិត្ត	ច・ា・ល・ច・ិ・ត・្・ត
ចាល់ចិត្ត	ច・ា・ល・់・ច・ិ・ត・្・ត
ចាស់ចិត្តចាស់គំនិត	ច・ា・ស・់・ច・ិ・ត・្・ត・ច・ា・ស・់・គ・ំ・ន・ិ・ត
ចិត្ត	ច・ិ・ត・្・ត
ខ្លោចចិត្ត	ខ・្・ល・ោ・ច・ច・ិ・ត・្・ត
គាប់ចិត្ត	គ・ា・ប・់・ច・ិ・ត・្・ត
ចិត្តខ្មៅ	ច・ិ・ត・្・ត・ខ・្・ម・ៅ
ចិត្តខ្លាំង	ច・ិ・ត・្・ត・ខ・្・ល・ា・ំ・ង
ចិត្តចង្អៀត	ច・ិ・ត・្・ត・ច・ង・្・អ・ៀ・ត
ចិត្តចោរ	ច・ិ・ត・្・ត・ច・ោ・រ
ចិត្តច្រើន	ច・ិ・ត・្・ត・ច・្・រ・ើ・ន
ចិត្តជា	ច・ិ・ត・្・ត・ជ・ា
ចិត្តដាច់	ច・ិ・ត・្・ត・ដ・ា・ច・់
ចិត្តទូលាយ	ច・ិ・ត・្・ត・ទ・ូ・ល・ា・យ
ចិត្តធ្ងន់	ច・ិ・ត・្・ត・ធ・្・ង・ន・់
ចិត្តធំ	ច・ិ・ត・្・ត・ធ・ំ
ចិត្តពាល	ច・ិ・ត・្・ត・ព・ា・ល
ចិត្តព្រះ	ច・ិ・ត・្・ត・ព・្・រ・ះ
ចិត្តវិជ្ជា	ច・ិ・ត・្・ត・វ・ិ・ជ・្・ជ・ា
ចិត្តសាមាន្យ	ច・ិ・ត・្・ត・ស・ា・ម・ា・ន・្・យ
ចិត្តសោមនស្ស	ច・ិ・ត・្・ត・ស・ោ・ម・ន・ស・្・ស
ចិត្តស្រាល	ច・ិ・ត・្・ត・ស・្・រ・ា・ល
ចិត្តស្លុយ	ច・ិ・ត・្・ត・ស・្・ល・ុ・យ
ចិត្តហានក្លា	ច・ិ・ត・្・ត・ហ・ា・ន・ក・្・ល・ា
ចិត្តអប្រិយ	ច・ិ・ត・្・ត・អ・ប・្・រ・ិ・យ
ដាច់ចិត្ត	ដ・ា・ច・់・ច・ិ・ត・្・ត
ទាន់ចិត្ត	ទ・ា・ន・់・ច・ិ・ត・្・ត
ចិត្ត	ច・ិ・ត・្・ត
ចិត្តកម្ម	ច・ិ・ត・្・ត・ក・ម・្・ម
ចិត្តការ	ច・ិ・ត・្・ត・ក・ា・រ
ចិត្តការិកា	ច・ិ・ត・្・ត・ក・ា・រ・ិ・ក・ា
ចិត្ត—	ច・ិ・ត・្・ត・—
ចិត្តគំនិត	ច・ិ・ត・្・ត・គ・ំ・ន・ិ・ត
ចិត្តព្យាបាល	ច・ិ・ត・្・ត・ព・្・យ・ា・ប・ា・ល
ចិត្តវិទ្យា	ច・ិ・ត・្・ត・វ・ិ・ទ・្・យ・ា
ចិត្តសាស្ត្រ	ច・ិ・ត・្・ត・ស・ា・ស・្・ត・្・រ
ចិត្តានុរូប	ច・ិ・ត・្・ត・ា・ន・ុ・រ・ូ・ប
ចិត្តុម្មត្តកៈ	ច・ិ・ត・្・ត・ុ・ម・្・ម・ត・្・ត・ក・ៈ
ចិត្តុម្មត្តកៈ	ច・ិ・ត・្・ត・ុ・ម・្・ម・ត・្・ត・ក・ៈ
ចុះចិត្ត	ច・ុ・ះ・ច・ិ・ត・្・ត
ចូលចិត្ត	ច・ូ・ល・ច・ិ・ត・្・ត
ចោរម័ត្ត	ច・ោ・រ・ម・័・ត・្・ត
ចំណុចចិត្ត	ច・ំ・ណ・ុ・ច・ច・ិ・ត・្・ត
ឆន្ទវុត្តិប្បទីប	ឆ・ន・្・ទ・វ・ុ・ត・្・ត・ិ・ប・្・ប・ទ・ី・ប
ឆ្កួតចិត្ត	ឆ・្・ក・ួ・ត・ច・ិ・ត・្・ត
ឆ្អែតចិត្ត	ឆ・្・អ・ែ・ត・ច・ិ・ត・្・ត
ជក់ចិត្ត	ជ・ក・់・ច・ិ・ត・្・ត
ជនេត្តិកា	ជ・ន・េ・ត・្・ត・ិ・ក・ា
ជនេត្តី	ជ・ន・េ・ត・្・ត・ី
ជនោត្តម	ជ・ន・ោ・ត・្・ត・ម
ជវនចិត្ត	ជ・វ・ន・ច・ិ・ត・្・ត
ជាតីឧត្តម	ជ・ា・ត・ី・ឧ・ត・្・ត・ម
ជាប់ចិត្ត	ជ・ា・ប・់・ច・ិ・ត・្・ត
ជាលបត្តសត្វ	ជ・ា・ល・ប・ត・្・ត・ស・ត・្・វ
ជីវប្បវត្តិ	ជ・ី・វ・ប・្・ប・វ・ត・្・ត・ិ
ជីវប្រវត្តិ	ជ・ី・វ・ប・្・រ・វ・ត・្・ត・ិ
ជីវព្រឹត្តិ	ជ・ី・វ・ព・្・រ・ឹ・ត・្・ត・ិ
ជើងវត្ត	ជ・ើ・ង・វ・ត・្・ត
ជេតុត្តរ	ជ・េ・ត・ុ・ត・្・ត・រ
ជំងឺចិត្ត	ជ・ំ・ង・ឺ・ច・ិ・ត・្・ត
ជំងឺផ្លូវចិត្ត	ជ・ំ・ង・ឺ・ផ・្・ល・ូ・វ・ច・ិ・ត・្・ត
ឈានចិត្ត	ឈ・ា・ន・ច・ិ・ត・្・ត
ឈឺចិត្ត	ឈ・ឺ・ច・ិ・ត・្・ត
ញត្តិ	ញ・ត・្・ត・ិ
ញត្តិកឋិន	ញ・ត・្・ត・ិ・ក・ឋ・ិ・ន
ញត្តិនាគ	ញ・ត・្・ត・ិ・ន・ា・គ
សូត្រញត្តិនាគ	ស・ូ・ត・្・រ・ញ・ត・្・ត・ិ・ន・ា・គ
ញត្តិកម្ម	ញ・ត・្・ត・ិ・ក・ម・្・ម
ញត្តិចតុត្ថកម្ម	ញ・ត・្・ត・ិ・ច・ត・ុ・ត・្・ថ・ក・ម・្・ម
ញត្តិទុតិយកម្ម	ញ・ត・្・ត・ិ・ទ・ុ・ត・ិ・យ・ក・ម・្・ម
ញាណវិប្បយុត្ត	ញ・ា・ណ・វ・ិ・ប・្・ប・យ・ុ・ត・្・ត
ញាណសម្បយុត្ត	ញ・ា・ណ・ស・ម・្・ប・យ・ុ・ត・្・ត
ញាតិបុត្ត	ញ・ា・ត・ិ・ប・ុ・ត・្・ត
ញោមវត្ត	ញ・ោ・ម・វ・ត・្・ត
ដាក់ចិត្ត	ដ・ា・ក・់・ច・ិ・ត・្・ត
ដាក់ចិត្តដាក់កាយ	ដ・ា・ក・់・ច・ិ・ត・្・ត・ដ・ា・ក・់・ក・ា・យ
ដឹងចិត្តដឹងថ្លើម	ដ・ឹ・ង・ច・ិ・ត・្・ត・ដ・ឹ・ង・ថ・្・ល・ើ・ម
ដួងចិត្ត	ដ・ួ・ង・ច・ិ・ត・្・ត
ដំបូងចិត្ត	ដ・ំ・ប・ូ・ង・ច・ិ・ត・្・ត
ដំបៅចិត្ត	ដ・ំ・ប・ៅ・ច・ិ・ត・្・ត
ណាយចិត្ត	ណ・ា・យ・ច・ិ・ត・្・ត
តតិយាវិភត្តិ	ត・ត・ិ・យ・ា・វ・ិ・ភ・ត・្・ត・ិ
តម្កល់ចិត្ត	ត・ម・្・ក・ល・់・ច・ិ・ត・្・ត
តរុណបុត្ត	ត・រ・ុ・ណ・ប・ុ・ត・្・ត
តាវត្តិង្ស	ត・ា・វ・ត・្・ត・ិ・ង・្・ស
តឹងចិត្ត	ត・ឹ・ង・ច・ិ・ត・្・ត
តុលាការយុត្តិធម៌អន្តរជាតិ	ត・ុ・ល・ា・ក・ា・រ・យ・ុ・ត・្・ត・ិ・ធ・ម・៌・អ・ន・្・ត・រ・ជ・ា・ត・ិ
តូចចិត្ត	ត・ូ・ច・ច・ិ・ត・្・ត
តំណឹងចិត្ត	ត・ំ・ណ・ឹ・ង・ច・ិ・ត・្・ត
តាំងចិត្ត	ត・ា・ំ・ង・ច・ិ・ត・្・ត
ត្រណាក់ចិត្ត	ត・្・រ・ណ・ា・ក・់・ច・ិ・ត・្・ត
ត្រមោងចិត្ត	ត・្・រ・ម・ោ・ង・ច・ិ・ត・្・ត
ត្រីពិធសម្បត្តិ	ត・្・រ・ី・ព・ិ・ធ・ស・ម・្・ប・ត・្・ត・ិ
ត្រូវចិត្ត	ត・្・រ・ូ・វ・ច・ិ・ត・្・ត
ត្រៃពិធសម្បត្តិ	ត・្・រ・ៃ・ព・ិ・ធ・ស・ម・្・ប・ត・្・ត・ិ
ត្រៃភូមិកចិត្ត	ត・្・រ・ៃ・ភ・ូ・ម・ិ・ក・ច・ិ・ត・្・ត
ថវិកាខេត្ត	ថ・វ・ិ・ក・ា・ខ・េ・ត・្・ត
ថេយ្យចិត្ត	ថ・េ・យ・្・យ・ច・ិ・ត・្・ត
ថ្លាចិត្ត	ថ・្・ល・ា・ច・ិ・ត・្・ត
ថ្លោសចិត្តថ្លោសគំនិត	ថ・្・ល・ោ・ស・ច・ិ・ត・្・ត・ថ・្・ល・ោ・ស・គ・ំ・ន・ិ・ត
ទត្តាត្រេយ	ទ・ត・្・ត・ា・ត・្・រ・េ・យ
ទន្ទ្រានខេត្ត	ទ・ន・្・ទ・្・រ・ា・ន・ខ・េ・ត・្・ត
ទម្លាក់ចិត្ត	ទ・ម・្・ល・ា・ក・់・ច・ិ・ត・្・ត
ចិត្តទស្សនវិជ្ជា	ច・ិ・ត・្・ត・ទ・ស・្・ស・ន・វ・ិ・ជ・្・ជ・ា
ទឡ្ហមិត្ត	ទ・ឡ・្・ហ・ម・ិ・ត・្・ត
ទារុណវិបត្ត	ទ・ា・រ・ុ・ណ・វ・ិ・ប・ត・្・ត
ទារុណវិបត្តិ 	ទ・ា・រ・ុ・ណ・វ・ិ・ប・ត・្・ត・ិ・ 
ទាស់ចិត្ត	ទ・ា・ស・់・ច・ិ・ត・្・ត
ទិដ្ឋមត្ត	ទ・ិ・ដ・្・ឋ・ម・ត・្・ត
ទិដ្ឋមត្តក៍	ទ・ិ・ដ・្・ឋ・ម・ត・្・ត・ក・៍
ទិដ្ឋិវិបត្តិ	ទ・ិ・ដ・្・ឋ・ិ・វ・ិ・ប・ត・្・ត・ិ
ទិដ្ឋិសម្បត្តិ	ទ・ិ・ដ・្・ឋ・ិ・ស・ម・្・ប・ត・្・ត・ិ
ទិនានុប្បវត្តិ	ទ・ិ・ន・ា・ន・ុ・ប・្・ប・វ・ត・្・ត・ិ
ទិនានុប្រព្រឹត្តិ	ទ・ិ・ន・ា・ន・ុ・ប・្・រ・ព・្・រ・ឹ・ត・្・ត・ិ
ទិវានុព្រឹត្តិ	ទ・ិ・វ・ា・ន・ុ・ព・្・រ・ឹ・ត・្・ត・ិ
ទីផ្សារកត្តាផលិតកម្ម	ទ・ី・ផ・្・ស・ា・រ・ក・ត・្・ត・ា・ផ・ល・ិ・ត・ក・ម・្・ម
ទីរួមខេត្ត	ទ・ី・រ・ួ・ម・ខ・េ・ត・្・ត
ទឹកចិត្ត	ទ・ឹ・ក・ច・ិ・ត・្・ត
ទុកចិត្ត	ទ・ុ・ក・ច・ិ・ត・្・ត
ទុក្កដាបត្តិ	ទ・ុ・ក・្・ក・ដ・ា・ប・ត・្・ត・ិ
ទុតិយាវិភត្តិ	ទ・ុ・ត・ិ・យ・ា・វ・ិ・ភ・ត・្・ត・ិ
ទុព្វចមិត្ត	ទ・ុ・ព・្・វ・ច・ម・ិ・ត・្・ត
ទេវបុត្ត	ទ・េ・វ・ប・ុ・ត・្・ត
ទេវទត្ត	ទ・េ・វ・ទ・ត・្・ត
ចិត្តជាទេវទត្តមាត់ជាទេវតា	ច・ិ・ត・្・ត・ជ・ា・ទ・េ・វ・ទ・ត・្・ត・ម・ា・ត・់・ជ・ា・ទ・េ・វ・ត・ា
ចិត្តជាទេវទត្តមាត់ជាទេវតា	ច・ិ・ត・្・ត・ជ・ា・ទ・េ・វ・ទ・ត・្・ត・ម・ា・ត・់・ជ・ា・ទ・េ・វ・ត・ា
ទេវបុត្តមារ	ទ・េ・វ・ប・ុ・ត・្・ត・ម・ា・រ
ទោសចិត្ត	ទ・ោ・ស・ច・ិ・ត・្・ត
ទ្រព្យសម្បត្តិ	ទ・្・រ・ព・្・យ・ស・ម・្・ប・ត・្・ត・ិ
ទ្រាន់ចិត្ត	ទ・្・រ・ា・ន・់・ច・ិ・ត・្・ត
ទ្រើសចិត្ត	ទ・្・រ・ើ・ស・ច・ិ・ត・្・ត
ទ្វិបត្តសត្វ	ទ・្・វ・ិ・ប・ត・្・ត・ស・ត・្・វ
ទ្វេបត្ត	ទ・្・វ・េ・ប・ត・្・ត
ធនលាភឩត្តរជីវី	ធ・ន・ល・ា・ភ・ឩ・ត・្・ត・រ・ជ・ី・វ・ី
ធម្មចក្កប្បវត្តនសូត្រ	ធ・ម・្・ម・ច・ក・្・ក・ប・្・ប・វ・ត・្・ត・ន・ស・ូ・ត・្・រ
ធម្មប្បដិបត្តិ	ធ・ម・្・ម・ប・្・ប・ដ・ិ・ប・ត・្・ត・ិ
ធម្មយុត្ត	ធ・ម・្・ម・យ・ុ・ត・្・ត
ធម្មយុត្តិ	ធ・ម・្・ម・យ・ុ・ត・្・ត・ិ
ធម្មយុត្តិកនិកាយ	ធ・ម・្・ម・យ・ុ・ត・្・ត・ិ・ក・ន・ិ・ក・ា・យ
ធរមានប្បញ្ញត្តិ	ធ・រ・ម・ា・ន・ប・្・ប・ញ・្・ញ・ត・្・ត・ិ
ធ្យានចិត្ត	ធ・្・យ・ា・ន・ច・ិ・ត・្・ត
នក្ខត្ត	ន・ក・្・ខ・ត・្・ត
នក្ខត្តឫក្ស	ន・ក・្・ខ・ត・្・ត・ឫ・ក・្・ស
នគរវត្ត	ន・គ・រ・វ・ត・្・ត
នត្តា	ន・ត・្・ត・ា
នព្វលោកុត្តរ	ន・ព・្・វ・ល・ោ・ក・ុ・ត・្・ត・រ
នព្វលោកុត្តរធម៌	ន・ព・្・វ・ល・ោ・ក・ុ・ត・្・ត・រ・ធ・ម・៌
នរោត្តម	ន・រ・ោ・ត・្・ត・ម
នវានុវត្តន៍	ន・វ・ា・ន・ុ・វ・ត・្・ត・ន・៍
នាមប្បញ្ញត្តិ	ន・ា・ម・ប・្・ប・ញ・្・ញ・ត・្・ត・ិ
និច្ចភត្ត	ន・ិ・ច・្・ច・ភ・ត・្・ត
និមិត្ត	ន・ិ・ម・ិ・ត・្・ត
និមិត្ត	ន・ិ・ម・ិ・ត・្・ត
និមិត្តរូប	ន・ិ・ម・ិ・ត・្・ត・រ・ូ・ប
និមិត្តរូបនិយម	ន・ិ・ម・ិ・ត・្・ត・រ・ូ・ប・ន・ិ・យ・ម
និមិត្តរូបារម្មណ៍	ន・ិ・ម・ិ・ត・្・ត・រ・ូ・ប・ា・រ・ម・្・ម・ណ・៍
និមិត្តសញ្ញា	ន・ិ・ម・ិ・ត・្・ត・ស・ញ・្・ញ・ា
និមិត្តហេតុ	ន・ិ・ម・ិ・ត・្・ត・ហ・េ・ត・ុ
និមុត្តិ	ន・ិ・ម・ុ・ត・្・ត・ិ
និមុត្តិកិច្ច	ន・ិ・ម・ុ・ត・្・ត・ិ・ក・ិ・ច・្・ច
និមុត្តិធានា	ន・ិ・ម・ុ・ត・្・ត・ិ・ធ・ា・ន・ា
និរុត្តិ	ន・ិ・រ・ុ・ត・្・ត・ិ
និរុត្តិ	ន・ិ・រ・ុ・ត・្・ត・ិ
និរុត្តិប្បដិសម្ភិទា	ន・ិ・រ・ុ・ត・្・ត・ិ・ប・្・ប・ដ・ិ・ស・ម・្・ភ・ិ・ទ・ា
និរុត្តិវិទូ	ន・ិ・រ・ុ・ត・្・ត・ិ・វ・ិ・ទ・ូ
និរុត្តិសាស្ត្រ	ន・ិ・រ・ុ・ត・្・ត・ិ・ស・ា・ស・្・ត・្・រ
និរុត្តិសាស្ត្រគម្ពីរ	ន・ិ・រ・ុ・ត・្・ត・ិ・ស・ា・ស・្・ត・្・រ・គ・ម・្・ព・ី・រ
និវត្ត	ន・ិ・វ・ត・្・ត
និវត្តជន	ន・ិ・វ・ត・្・ត・ជ・ន
និវត្តនាការ	ន・ិ・វ・ត・្・ត・ន・ា・ក・ា・រ
និវត្តន៍	ន・ិ・វ・ត・្・ត・ន・៍
និស្សយមុត្តកៈ	ន・ិ・ស・្・ស・យ・ម・ុ・ត・្・ត・ក・ៈ
និស្សយមុត្តិកា	ន・ិ・ស・្・ស・យ・ម・ុ・ត・្・ត・ិ・ក・ា
នីតិប្បញ្ញត្តិ	ន・ី・ត・ិ・ប・្・ប・ញ・្・ញ・ត・្・ត・ិ
នីតិប្រតិបត្តិ	ន・ី・ត・ិ・ប・្・រ・ត・ិ・ប・ត・្・ត・ិ
បកវត្ត	ប・ក・វ・ត・្・ត
បច្ចាមិត្ត	ប・ច・្・ច・ា・ម・ិ・ត・្・ត
បច្ឆាភត្ត	ប・ច・្・ឆ・ា・ភ・ត・្・ត
បច្ឆាភត្តកាល	ប・ច・្・ឆ・ា・ភ・ត・្・ត・ក・ា・ល
បច្ឆាភត្តកិច្ច	ប・ច・្・ឆ・ា・ភ・ត・្・ត・ក・ិ・ច・្・ច
បច្ឆិមភវិកសត្ត	ប・ច・្・ឆ・ិ・ម・ភ・វ・ិ・ក・ស・ត・្・ត
បច្ឆិមត្តភាព	ប・ច・្・ឆ・ិ・ម・ត・្・ត・ភ・ា・ព
បញ្ចាំចិត្ត	ប・ញ・្・ច・ា・ំ・ច・ិ・ត・្・ត
បញ្ជោកចិត្ត	ប・ញ・្・ជ・ោ・ក・ច・ិ・ត・្・ត
បញ្ញត្ត	ប・ញ・្・ញ・ត・្・ត
បញ្ញត្តិ	ប・ញ・្・ញ・ត・្・ត・ិ
បញ្ញត្តិ–	ប・ញ・្・ញ・ត・្・ត・ិ・–
បញ្ញត្តិកម្ម	ប・ញ・្・ញ・ត・្・ត・ិ・ក・ម・្・ម
បញ្ញត្តិករ	ប・ញ・្・ញ・ត・្・ត・ិ・ក・រ
បដិឃចិត្ត	ប・ដ・ិ・ឃ・ច・ិ・ត・្・ត
បដិបញ្ញត្តិ	ប・ដ・ិ・ប・ញ・្・ញ・ត・្・ត・ិ
បដិបត្តិ	ប・ដ・ិ・ប・ត・្・ត・ិ
បដិប្បញ្ញត្ត	ប・ដ・ិ・ប・្・ប・ញ・្・ញ・ត・្・ត
បដិប្បញ្ញត្តិ	ប・ដ・ិ・ប・្・ប・ញ・្・ញ・ត・្・ត・ិ
បដិភាគនិមិត្ត	ប・ដ・ិ・ភ・ា・គ・ន・ិ・ម・ិ・ត・្・ត
បដិវត្ត	ប・ដ・ិ・វ・ត・្・ត
បដិវត្តបុគ្គល	ប・ដ・ិ・វ・ត・្・ត・ប・ុ・គ・្・គ・ល
បដិវត្តន៍	ប・ដ・ិ・វ・ត・្・ត・ន・៍
បដិវត្តន៍កសិកម្ម	ប・ដ・ិ・វ・ត・្・ត・ន・៍・ក・ស・ិ・ក・ម・្・ម
បដិវត្តន៍បៃតង	ប・ដ・ិ・វ・ត・្・ត・ន・៍・ប・ៃ・ត・ង
បឋមប្បញ្ញត្តិ	ប・ឋ・ម・ប・្・ប・ញ・្・ញ・ត・្・ត・ិ
បឋមាវិភត្តិ	ប・ឋ・ម・ា・វ・ិ・ភ・ត・្・ត・ិ
បណ្ដូលចិត្ត	ប・ណ・្・ដ・ូ・ល・ច・ិ・ត・្・ត
បត្តបិណ្ឌិកង្គៈ	ប・ត・្・ត・ប・ិ・ណ・្・ឌ・ិ・ក・ង・្・គ・ៈ
បត្តានីក	ប・ត・្・ត・ា・ន・ី・ក
បត្តានុមោទនាមយៈ	ប・ត・្・ត・ា・ន・ុ・ម・ោ・ទ・ន・ា・ម・យ・ៈ
បត្តិទានមយៈ	ប・ត・្・ត・ិ・ទ・ា・ន・ម・យ・ៈ
បទបញ្ញត្តិ	ប・ទ・ប・ញ・្・ញ・ត・្・ត・ិ
បទប្បញ្ញត្តិ	ប・ទ・ប・្・ប・ញ・្・ញ・ត・្・ត・ិ
បទេសបញ្ញត្តិ	ប・ទ・េ・ស・ប・ញ・្・ញ・ត・្・ត・ិ
បទេសប្បញ្ញត្តិ	ប・ទ・េ・ស・ប・្・ប・ញ・្・ញ・ត・្・ត・ិ
បន្សុទ្ធចិត្ត	ប・ន・្・ស・ុ・ទ・្・ធ・ច・ិ・ត・្・ត
បរិចត្តបុគ្គល	ប・រ・ិ・ច・ត・្・ត・ប・ុ・គ・្・គ・ល
បរិច្ចត្តគ្រាហក	ប・រ・ិ・ច・្・ច・ត・្・ត・គ・្・រ・ា・ហ・ក
បរិច្ចត្តបុគ្គល	ប・រ・ិ・ច・្・ច・ត・្・ត・ប・ុ・គ・្・គ・ល
បរិត្ត	ប・រ・ិ・ត・្・ត
បរិត្តផរណា	ប・រ・ិ・ត・្・ត・ផ・រ・ណ・ា
បរិត្តផរណាករ	ប・រ・ិ・ត・្・ត・ផ・រ・ណ・ា・ក・រ
បរិយត្តិ	ប・រ・ិ・យ・ត・្・ត・ិ
បរិយត្តិធម៌	ប・រ・ិ・យ・ត・្・ត・ិ・ធ・ម・៌
បរិវត្តន៍	ប・រ・ិ・វ・ត・្・ត・ន・៍
បរិវត្តន៍វប្បធម៌	ប・រ・ិ・វ・ត・្・ត・ន・៍・វ・ប・្・ប・ធ・ម・៌
បវត្តិ	ប・វ・ត・្・ត・ិ
បវត្តិការណ៍	ប・វ・ត・្・ត・ិ・ក・ា・រ・ណ・៍
បវត្តិកាល	ប・វ・ត・្・ត・ិ・ក・ា・ល
បវត្តិរូប	ប・វ・ត・្・ត・ិ・រ・ូ・ប
បវត្តិសាស្ត្រ	ប・វ・ត・្・ត・ិ・ស・ា・ស・្・ត・្・រ
បវត្តិហេតុ	ប・វ・ត・្・ត・ិ・ហ・េ・ត・ុ
បាក់ចិត្ត	ប・ា・ក・់・ច・ិ・ត・្・ត
បាចិត្តិយៈ	ប・ា・ច・ិ・ត・្・ត・ិ・យ・ៈ
បានចិត្ត	ប・ា・ន・ច・ិ・ត・្・ត
បាបចិត្ត	ប・ា・ប・ច・ិ・ត・្・ត
បាបមិត្ត	ប・ា・ប・ម・ិ・ត・្・ត
បាយបត្តបូរ	ប・ា・យ・ប・ត・្・ត・ប・ូ・រ
បារាជិកាបត្តិ	ប・ា・រ・ា・ជ・ិ・ក・ា・ប・ត・្・ត・ិ
បិណ្ឌបាតចារិកវត្ត	ប・ិ・ណ・្・ឌ・ប・ា・ត・ច・ា・រ・ិ・ក・វ・ត・្・ត
បិត្តបូរ	ប・ិ・ត・្・ត・ប・ូ・រ
បិត្តាស័យ	ប・ិ・ត・្・ត・ា・ស・័・យ
បុគ្គលប្បញ្ញត្តិ	ប・ុ・គ・្・គ・ល・ប・្・ប・ញ・្・ញ・ត・្・ត・ិ
បុញ្ញក្ខេត្ត	ប・ុ・ញ・្・ញ・ក・្・ខ・េ・ត・្・ត
បុត្ត	ប・ុ・ត・្・ត
បុត្តភាព	ប・ុ・ត・្・ត・ភ・ា・ព
បុត្តា	ប・ុ・ត・្・ត・ា
បុនរាព្រឹត្តិ	ប・ុ・ន・រ・ា・ព・្・រ・ឹ・ត・្・ត・ិ
បុនរុត្តិ	ប・ុ・ន・រ・ុ・ត・្・ត・ិ
បុនរុត្តិវិធី	ប・ុ・ន・រ・ុ・ត・្・ត・ិ・វ・ិ・ធ・ី
បុព្វនិមិត្ត	ប・ុ・ព・្・វ・ន・ិ・ម・ិ・ត・្・ត
បុព្វភាគបដិបត្តិ	ប・ុ・ព・្・វ・ភ・ា・គ・ប・ដ・ិ・ប・ត・្・ត・ិ
បុព្វភាគប្រតិបត្តិ	ប・ុ・ព・្・វ・ភ・ា・គ・ប・្・រ・ត・ិ・ប・ត・្・ត・ិ
បុរេប្រវត្តិ	ប・ុ・រ・េ・ប・្・រ・វ・ត・្・ត・ិ
បុរេប្រវត្តិវិទូ	ប・ុ・រ・េ・ប・្・រ・វ・ត・្・ត・ិ・វ・ិ・ទ・ូ
បុរេប្រវត្តិវិទ្យា	ប・ុ・រ・េ・ប・្・រ・វ・ត・្・ត・ិ・វ・ិ・ទ・្・យ・ា
បុរេប្រវត្តិសាស្រ្ត	ប・ុ・រ・េ・ប・្・រ・វ・ត・្・ត・ិ・ស・ា・ស・្・រ・្・ត
បុរេភត្ត	ប・ុ・រ・េ・ភ・ត・្・ត
បុរេភត្តកាល	ប・ុ・រ・េ・ភ・ត・្・ត・ក・ា・ល
បុរេភត្តកិច្ច	ប・ុ・រ・េ・ភ・ត・្・ត・ក・ិ・ច・្・ច
បូព៌និមិត្ត	ប・ូ・ព・៌・ន・ិ・ម・ិ・ត・្・ត
បេត្តេយ្យកា	ប・េ・ត・្・ត・េ・យ・្・យ・ក・ា
បែកចិត្ត	ប・ែ・ក・ច・ិ・ត・្・ត
បែរចិត្ត	ប・ែ・រ・ច・ិ・ត・្・ត
បំពុលចិត្ត	ប・ំ・ព・ុ・ល・ច・ិ・ត・្・ត
ប្រកាសទ្រព្យសម្បត្តិ	ប・្・រ・ក・ា・ស・ទ・្・រ・ព・្・យ・ស・ម・្・ប・ត・្・ត・ិ
ប្រចិត្ត	ប・្・រ・ច・ិ・ត・្・ត
មិត្តប្រចុប	ម・ិ・ត・្・ត・ប・្・រ・ច・ុ・ប
ប្រតិបដិវត្តន៍	ប・្・រ・ត・ិ・ប・ដ・ិ・វ・ត・្・ត・ន・៍
ប្រតិបត្តករ	ប・្・រ・ត・ិ・ប・ត・្・ត・ក・រ
ប្រតិបត្តិ	ប・្・រ・ត・ិ・ប・ត・្・ត・ិ
ប្រតិបត្តិករ	ប・្・រ・ត・ិ・ប・ត・្・ត・ិ・ក・រ
ប្រតិបត្តិករផ្នែកលក់	ប・្・រ・ត・ិ・ប・ត・្・ត・ិ・ក・រ・ផ・្・ន・ែ・ក・ល・ក・់
ប្រតិបត្តិនិយម	ប・្・រ・ត・ិ・ប・ត・្・ត・ិ・ន・ិ・យ・ម
ប្រព្រឹត្ត	ប・្・រ・ព・្・រ・ឹ・ត・្・ត
ប្រព្រឹត្តិ	ប・្・រ・ព・្・រ・ឹ・ត・្・ត・ិ
ប្រព្រឹត្តការណ៍	ប・្・រ・ព・្・រ・ឹ・ត・្・ត・ក・ា・រ・ណ・៍
ប្រព្រឹត្តិហេតុ	ប・្・រ・ព・្・រ・ឹ・ត・្・ត・ិ・ហ・េ・ត・ុ
ប្រព្រឹត្តិកម្ម	ប・្・រ・ព・្・រ・ឹ・ត・្・ត・ិ・ក・ម・្・ម
ប្រព្រឹត្តិការ	ប・្・រ・ព・្・រ・ឹ・ត・្・ត・ិ・ក・ា・រ
ប្រព្រឹត្តិការណ៍	ប・្・រ・ព・្・រ・ឹ・ត・្・ត・ិ・ក・ា・រ・ណ・៍
ប្រយោគវិបត្តិ	ប・្・រ・យ・ោ・គ・វ・ិ・ប・ត・្・ត・ិ
ប្រយោគសម្បត្តិ	ប・្・រ・យ・ោ・គ・ស・ម・្・ប・ត・្・ត・ិ
ប្រវត្តិ	ប・្・រ・វ・ត・្・ត・ិ
ប្រវត្តិរូប	ប・្・រ・វ・ត・្・ត・ិ・រ・ូ・ប
ប្រវត្តិវិទ្យា	ប・្・រ・វ・ត・្・ត・ិ・វ・ិ・ទ・្・យ・ា
ប្រវត្តិសាស្ត្រ	ប・្・រ・វ・ត・្・ត・ិ・ស・ា・ស・្・ត・្・រ
ប្រវត្តិសាស្ត្រិន	ប・្・រ・វ・ត・្・ត・ិ・ស・ា・ស・្・ត・្・រ・ិ・ន
ប្រវត្តិហេតុ	ប・្・រ・វ・ត・្・ត・ិ・ហ・េ・ត・ុ
ប្រាក់លើកទឹកចិត្ត	ប・្・រ・ា・ក・់・ល・ើ・ក・ទ・ឹ・ក・ច・ិ・ត・្・ត
ប្រាក់សោធននិវត្ត	ប・្・រ・ា・ក・់・ស・ោ・ធ・ន・ន・ិ・វ・ត・្・ត
ប្រិយមិត្ត	ប・្・រ・ិ・យ・ម・ិ・ត・្・ត
ប្រែចិត្ត	ប・្・រ・ែ・ច・ិ・ត・្・ត
សូមទានមេត្តាប្រោស	ស・ូ・ម・ទ・ា・ន・ម・េ・ត・្・ត・ា・ប・្・រ・ោ・ស
សូមទ្រង់ព្រះមេត្តាប្រោស	ស・ូ・ម・ទ・្・រ・ង・់・ព・្・រ・ះ・ម・េ・ត・្・ត・ា・ប・្・រ・ោ・ស
សូមទ្រង់មេត្តាប្រោស	ស・ូ・ម・ទ・្・រ・ង・់・ម・េ・ត・្・ត・ា・ប・្・រ・ោ・ស
ប្លុងចិត្ត	ប・្・ល・ុ・ង・ច・ិ・ត・្・ត
ផលចិត្ត	ផ・ល・ច・ិ・ត・្・ត
ផ្ចង់ចិត្ត	ផ・្・ច・ង・់・ច・ិ・ត・្・ត
ផ្ដេកចិត្ត	ផ・្・ដ・េ・ក・ច・ិ・ត・្・ត
ផ្ដោតចិត្ត	ផ・្・ដ・ោ・ត・ច・ិ・ត・្・ត
ផ្លូវខេត្ត	ផ・្・ល・ូ・វ・ខ・េ・ត・្・ត
ពង្សប្រព្រឹត្ត	ព・ង・្・ស・ប・្・រ・ព・្・រ・ឹ・ត・្・ត
ពង្សប្រព្រឹត្តិ	ព・ង・្・ស・ប・្・រ・ព・្・រ・ឹ・ត・្・ត・ិ
ពង្សប្រវត្តិ	ព・ង・្・ស・ប・្・រ・វ・ត・្・ត・ិ
ពត់ចិត្ត	ព・ត・់・ច・ិ・ត・្・ត
ពីជបត្ត	ព・ី・ជ・ប・ត・្・ត
ពុទ្ធបញ្ញត្តិ	ព・ុ・ទ・្・ធ・ប・ញ・្・ញ・ត・្・ត・ិ
ពុទ្ធបវត្តិ	ព・ុ・ទ・្・ធ・ប・វ・ត・្・ត・ិ
ពុទ្ធបុត្ត	ព・ុ・ទ・្・ធ・ប・ុ・ត・្・ត
ពុទ្ធប្បញ្ញត្តិ	ព・ុ・ទ・្・ធ・ប・្・ប・ញ・្・ញ・ត・្・ត・ិ
ពុទ្ធប្បវត្តិ	ព・ុ・ទ・្・ធ・ប・្・ប・វ・ត・្・ត・ិ
ពុទ្ធប្រវត្តិ	ព・ុ・ទ・្・ធ・ប・្・រ・វ・ត・្・ត・ិ
ពុទ្ធសាសនប្បវត្តិ	ព・ុ・ទ・្・ធ・ស・ា・ស・ន・ប・្・ប・វ・ត・្・ត・ិ
ពុរចិត្ត	ព・ុ・រ・ច・ិ・ត・្・ត
កពូនសម្បត្តិ	ក・ព・ូ・ន・ស・ម・្・ប・ត・្・ត・ិ
ពេញចិត្ត	ព・េ・ញ・ច・ិ・ត・្・ត
ព្យត្តបុគ្គល	ព・្・យ・ត・្・ត・ប・ុ・គ・្・គ・ល
ព្យត្តភាព	ព・្・យ・ត・្・ត・ភ・ា・ព
ព្យត្តវោហារ	ព・្・យ・ត・្・ត・វ・ោ・ហ・ា・រ
ប្រព្រឹត្តមិនឱ្យល្អៀងអំពីព្រត	ប・្・រ・ព・្・រ・ឹ・ត・្・ត・ម・ិ・ន・ឱ・្・យ・ល・្・អ・ៀ・ង・អ・ំ・ព・ី・ព・្・រ・ត
ព្រហ្មទត្ត	ព・្・រ・ហ・្・ម・ទ・ត・្・ត
ព្រឹត្តិ	ព・្・រ・ឹ・ត・្・ត・ិ
ព្រឹត្តិការ	ព・្・រ・ឹ・ត・្・ត・ិ・ក・ា・រ
ព្រឹត្តិការណ៍	ព・្・រ・ឹ・ត・្・ត・ិ・ក・ា・រ・ណ・៍
ព្រឹត្តិការណ៍	ព・្・រ・ឹ・ត・្・ត・ិ・ក・ា・រ・ណ・៍
ព្រឹត្តិការិកា	ព・្・រ・ឹ・ត・្・ត・ិ・ក・ា・រ・ិ・ក・ា
ព្រឹត្តិកាល	ព・្・រ・ឹ・ត・្・ត・ិ・ក・ា・ល
ព្រឹត្តិបត្រ	ព・្・រ・ឹ・ត・្・ត・ិ・ប・ត・្・រ
ព្រួយចិត្ត	ព・្・រ・ួ・យ・ច・ិ・ត・្・ត
ចិត្តព្រែក	ច・ិ・ត・្・ត・ព・្・រ・ែ・ក
ភត្ត	ភ・ត・្・ត
ភត្ត–	ភ・ត・្・ត・–
ភត្តការ	ភ・ត・្・ត・ក・ា・រ
ភត្តការិកា	ភ・ត・្・ត・ក・ា・រ・ិ・ក・ា
ភត្តការិនី	ភ・ត・្・ត・ក・ា・រ・ិ・ន・ី
ភត្តការី	ភ・ត・្・ត・ក・ា・រ・ី
ភត្តកាល	ភ・ត・្・ត・ក・ា・ល
ភត្តកិច្ច	ភ・ត・្・ត・ក・ិ・ច・្・ច
ភត្តតិរែក	ភ・ត・្・ត・ត・ិ・រ・ែ・ក
ភត្តាគារ	ភ・ត・្・ត・ា・គ・ា・រ
ភត្តានុមោទនា	ភ・ត・្・ត・ា・ន・ុ・ម・ោ・ទ・ន・ា
ភត្តាភិហារ	ភ・ត・្・ត・ា・ភ・ិ・ហ・ា・រ
ភត្តាវសាន	ភ・ត・្・ត・ា・វ・ស・ា・ន
ភត្តាហារ	ភ・ត・្・ត・ា・ហ・ា・រ
ភត្តុទ្ទេសកៈ	ភ・ត・្・ត・ុ・ទ・្・ទ・េ・ស・ក・ៈ
ភត្តុទ្ទេសក៍	ភ・ត・្・ត・ុ・ទ・្・ទ・េ・ស・ក・៍
ភាតុបុត្ត	ភ・ា・ត・ុ・ប・ុ・ត・្・ត
ភាសាបរិវត្តកៈ	ភ・ា・ស・ា・ប・រ・ិ・វ・ត・្・ត・ក・ៈ
ភាសាបរិវត្តន៍	ភ・ា・ស・ា・ប・រ・ិ・វ・ត・្・ត・ន・៍
ភាសាបរិវត្តិកា	ភ・ា・ស・ា・ប・រ・ិ・វ・ត・្・ត・ិ・ក・ា
ភិក្ខាចារវត្ត	ភ・ិ・ក・្・ខ・ា・ច・ា・រ・វ・ត・្・ត
កាត់ចិត្តភឹង	ក・ា・ត・់・ច・ិ・ត・្・ត・ភ・ឹ・ង
ដាច់ចិត្តភឹង	ដ・ា・ច・់・ច・ិ・ត・្・ត・ភ・ឹ・ង
ភុត្តសេស	ភ・ុ・ត・្・ត・ស・េ・ស
ភុត្តាវសេស	ភ・ុ・ត・្・ត・ា・វ・ស・េ・ស
មគ្គចិត្ត	ម・គ・្・គ・ច・ិ・ត・្・ត
មច្ឆេរចិត្ត	ម・ច・្・ឆ・េ・រ・ច・ិ・ត・្・ត
មជ្ឈត្តកម្ម	ម・ជ・្・ឈ・ត・្・ត・ក・ម・្・ម
មជ្ឈត្តករ	ម・ជ・្・ឈ・ត・្・ត・ក・រ
មជ្ឈត្តការ	ម・ជ・្・ឈ・ត・្・ត・ក・ា・រ
មជ្ឈត្តនិយម	ម・ជ・្・ឈ・ត・្・ត・ន・ិ・យ・ម
មជ្ឈត្តភាព	ម・ជ・្・ឈ・ត・្・ត・ភ・ា・ព
មជ្ឈត្តវិនិច្ឆ័យ	ម・ជ・្・ឈ・ត・្・ត・វ・ិ・ន・ិ・ច・្・ឆ・័・យ
មជ្ឈត្តារម្មណ៍	ម・ជ・្・ឈ・ត・្・ត・ា・រ・ម・្・ម・ណ・៍
មជ្ឈត្តិកៈ	ម・ជ・្・ឈ・ត・្・ត・ិ・ក・ៈ
មតកភត្ត	ម・ត・ក・ភ・ត・្・ត
មត្តញ្ញុតា	ម・ត・្・ត・ញ・្・ញ・ុ・ត・ា
មត្តញ្ញូ	ម・ត・្・ត・ញ・្・ញ・ូ
មត្តិកា	ម・ត・្・ត・ិ・ក・ា
មត្តិកាភណ្ឌ	ម・ត・្・ត・ិ・ក・ា・ភ・ណ・្・ឌ
មត្តិកាភាជន៍	ម・ត・្・ត・ិ・ក・ា・ភ・ា・ជ・ន・៍
មត្តេយ្យកា	ម・ត・្・ត・េ・យ・្・យ・ក・ា
មត្តេយ្យកៈ	ម・ត・្・ត・េ・យ・្・យ・ក・ៈ
មត្តេយ្យដ្ឋាន	ម・ត・្・ត・េ・យ・្・យ・ដ・្・ឋ・ា・ន
មត្តេយ្យសិក្សា	ម・ត・្・ត・េ・យ・្・យ・ស・ិ・ក・្・ស・ា
មន្ត្រីកិត្តិយស	ម・ន・្・ត・្・រ・ី・ក・ិ・ត・្・ត・ិ・យ・ស
មហត្តរស	ម・ហ・ត・្・ត・រ・ស
មហាខត្តិយវង្ស	ម・ហ・ា・ខ・ត・្・ត・ិ・យ・វ・ង・្・ស
មហាមិត្ត	ម・ហ・ា・ម・ិ・ត・្・ត
មហាសារីបុត្ត	ម・ហ・ា・ស・ា・រ・ី・ប・ុ・ត・្・ត
មហាចក្រពត្តិ	ម・ហ・ា・ច・ក・្・រ・ព・ត・្・ត・ិ
មហាសត្ត	ម・ហ・ា・ស・ត・្・ត
មហេសក្ខទេវបុត្ត	ម・ហ・េ・ស・ក・្・ខ・ទ・េ・វ・ប・ុ・ត・្・ត
ខាំមាត់សង្កត់ចិត្ត	ខ・ា・ំ・ម・ា・ត・់・ស・ង・្・ក・ត・់・ច・ិ・ត・្・ត
មាតុភូមិនិវត្តន៍	ម・ា・ត・ុ・ភ・ូ・ម・ិ・ន・ិ・វ・ត・្・ត・ន・៍
មានចិត្ត	ម・ា・ន・ច・ិ・ត・្・ត
មានចិត្តមានថ្លើម	ម・ា・ន・ច・ិ・ត・្・ត・ម・ា・ន・ថ・្・ល・ើ・ម
មានសម្បត្តិ	ម・ា・ន・ស・ម・្・ប・ត・្・ត・ិ
មាសានុប្បវត្តិ	ម・ា・ស・ា・ន・ុ・ប・្・ប・វ・ត・្・ត・ិ
មាសានុប្រព្រឹត្តិ	ម・ា・ស・ា・ន・ុ・ប・្・រ・ព・្・រ・ឹ・ត・្・ត・ិ
ចិត្តមច្ឆេរមិច្ឆា	ច・ិ・ត・្・ត・ម・ច・្・ឆ・េ・រ・ម・ិ・ច・្・ឆ・ា
មិត្ត	ម・ិ・ត・្・ត
មិត្តទ្រុស្ត	ម・ិ・ត・្・ត・ទ・្・រ・ុ・ស・្・ត
មិត្តទ្រុះ	ម・ិ・ត・្・ត・ទ・្・រ・ុ・ះ
មិត្តភាណិនី	ម・ិ・ត・្・ត・ភ・ា・ណ・ិ・ន・ី
មិត្តភាព	ម・ិ・ត・្・ត・ភ・ា・ព
មិត្តភេទ	ម・ិ・ត・្・ត・ភ・េ・ទ
មិត្តភ្ងា	ម・ិ・ត・្・ត・ភ・្・ង・ា
មិត្តលាភ	ម・ិ・ត・្・ត・ល・ា・ភ
មិត្តសន្ថវភាព	ម・ិ・ត・្・ត・ស・ន・្・ថ・វ・ភ・ា・ព
ចិត្តមុត	ច・ិ・ត・្・ត・ម・ុ・ត
មុត្តា	ម・ុ・ត・្・ត・ា
មុត្តាស័យ	ម・ុ・ត・្・ត・ា・ស・័・យ
មុត្តាហារ	ម・ុ・ត・្・ត・ា・ហ・ា・រ
មុទិតាចិត្ត	ម・ុ・ទ・ិ・ត・ា・ច・ិ・ត・្・ត
មុទុចិត្ត	ម・ុ・ទ・ុ・ច・ិ・ត・្・ត
មុទ្ធាភិសិត្ត	ម・ុ・ទ・្・ធ・ា・ភ・ិ・ស・ិ・ត・្・ត
មុទ្ធាភិសិត្តរាជ	ម・ុ・ទ・្・ធ・ា・ភ・ិ・ស・ិ・ត・្・ត・រ・ា・ជ
មុហុត្តវិជាតវាទី	ម・ុ・ហ・ុ・ត・្・ត・វ・ិ・ជ・ា・ត・វ・ា・ទ・ី
មូគវត្ត	ម・ូ・គ・វ・ត・្・ត
មូលចិត្ត	ម・ូ・ល・ច・ិ・ត・្・ត
មេត្តា	ម・េ・ត・្・ត・ា
មេត្តាកាយកម្ម	ម・េ・ត・្・ត・ា・ក・ា・យ・ក・ម・្・ម
មេត្តាចិត្ត	ម・េ・ត・្・ត・ា・ច・ិ・ត・្・ត
មេត្តាចិត្ត	ម・េ・ត・្・ត・ា・ច・ិ・ត・្・ត
មេត្តាធម៌	ម・េ・ត・្・ត・ា・ធ・ម・៌
មេត្តាប្រោស	ម・េ・ត・្・ត・ា・ប・្・រ・ោ・ស
មេត្តាភាវនា	ម・េ・ត・្・ត・ា・ភ・ា・វ・ន・ា
មេត្តាមនោកម្ម	ម・េ・ត・្・ត・ា・ម・ន・ោ・ក・ម・្・ម
មេត្តាវចីកម្ម	ម・េ・ត・្・ត・ា・វ・ច・ី・ក・ម・្・ម
មេត្តាវចីកម្ម,	ម・េ・ត・្・ត・ា・វ・ច・ី・ក・ម・្・ម・,
មេត្តាវិហារិនី	ម・េ・ត・្・ត・ា・វ・ិ・ហ・ា・រ・ិ・ន・ី
មេត្តាវិហារី	ម・េ・ត・្・ត・ា・វ・ិ・ហ・ា・រ・ី
មេត្តាបារមី	ម・េ・ត・្・ត・ា・ប・ា・រ・ម・ី
មេត្រីចិត្ត	ម・េ・ត・្・រ・ី・ច・ិ・ត・្・ត
មេវត្ត	ម・េ・វ・ត・្・ត
មោហចិត្ត	ម・ោ・ហ・ច・ិ・ត・្・ត
ម៉ាស៊ីនប្រតិបត្តិការធនាគារស្វ័យប្រវត្ត	ម・៉・ា・ស・៊・ី・ន・ប・្・រ・ត・ិ・ប・ត・្・ត・ិ・ក・ា・រ・ធ・ន・ា・គ・ា・រ・ស・្・វ・័・យ・ប・្・រ・វ・ត・្・ត
ម៉ាស៊ីនប្រតិបត្តិការធនាគារស្វ័យប្រវត្ត	ម・៉・ា・ស・៊・ី・ន・ប・្・រ・ត・ិ・ប・ត・្・ត・ិ・ក・ា・រ・ធ・ន・ា・គ・ា・រ・ស・្・វ・័・យ・ប・្・រ・វ・ត・្・ត
យកចិត្ត	យ・ក・ច・ិ・ត・្・ត
យកចិត្តទុកដាក់	យ・ក・ច・ិ・ត・្・ត・ទ・ុ・ក・ដ・ា・ក・់
យកចិត្តយកថ្លើម	យ・ក・ច・ិ・ត・្・ត・យ・ក・ថ・្・ល・ើ・ម
យមកបុត្ត	យ・ម・ក・ប・ុ・ត・្・ត
យល់ចិត្ត	យ・ល・់・ច・ិ・ត・្・ត
យាបនមត្ត	យ・ា・ប・ន・ម・ត・្・ត
យុត្តៈ	យ・ុ・ត・្・ត・ៈ
យុត្តកម្ម	យ・ុ・ត・្・ត・ក・ម・្・ម
យុត្តការណ៍	យ・ុ・ត・្・ត・ក・ា・រ・ណ・៍
យុត្តកិច្ច	យ・ុ・ត・្・ត・ក・ិ・ច・្・ច
យុត្តក្រឹត្យ	យ・ុ・ត・្・ត・ក・្・រ・ឹ・ត・្・យ
យុត្តចិន្តា	យ・ុ・ត・្・ត・ច・ិ・ន・្・ត・ា
យុត្តមតិ	យ・ុ・ត・្・ត・ម・ត・ិ
យុត្តវាចា	យ・ុ・ត・្・ត・វ・ា・ច・ា
យុត្តវាទ	យ・ុ・ត・្・ត・វ・ា・ទ
យុត្តវាទិនី	យ・ុ・ត・្・ត・វ・ា・ទ・ិ・ន・ី
យុត្តវាទី	យ・ុ・ត・្・ត・វ・ា・ទ・ី
យុត្តសង្គ្រាម	យ・ុ・ត・្・ត・ស・ង・្・គ・្・រ・ា・ម
យុត្តាធិការ	យ・ុ・ត・្・ត・ា・ធ・ិ・ក・ា・រ
យុត្តាប៊ីត	យ・ុ・ត・្・ត・ា・ប・៊・ី・ត
យុត្តិកម្ម	យ・ុ・ត・្・ត・ិ・ក・ម・្・ម
យុត្តិការ	យ・ុ・ត・្・ត・ិ・ក・ា・រ
យុត្តិធម៌	យ・ុ・ត・្・ត・ិ・ធ・ម・៌
យុត្តិនិសេធ	យ・ុ・ត・្・ត・ិ・ន・ិ・ស・េ・ធ
យុត្តិសាស្ត្រ	យ・ុ・ត・្・ត・ិ・ស・ា・ស・្・ត・្・រ
យ៉ុងចិត្ត	យ・៉・ុ・ង・ច・ិ・ត・្・ត
រកាំចិត្ត	រ・ក・ា・ំ・ច・ិ・ត・្・ត
រង្គាលចិត្ត	រ・ង・្・គ・ា・ល・ច・ិ・ត・្・ត
រណក្ខេត្ត	រ・ណ・ក・្・ខ・េ・ត・្・ត
រណមិត្ត	រ・ណ・ម・ិ・ត・្・ត
រតនសម្បត្តិ	រ・ត・ន・ស・ម・្・ប・ត・្・ត・ិ
រត្ត	រ・ត・្・ត
រត្តកម្ពល	រ・ត・្・ត・ក・ម・្・ព・ល
រត្តគាវី	រ・ត・្・ត・គ・ា・វ・ី
រត្តចន្ទន៍	រ・ត・្・ត・ច・ន・្・ទ・ន・៍
រត្តបឋវី	រ・ត・្・ត・ប・ឋ・វ・ី
រត្តរឿងរង្សី	រ・ត・្・ត・រ・ឿ・ង・រ・ង・្・ស・ី
រត្តសុវណ្ណ	រ・ត・្・ត・ស・ុ・វ・ណ・្・ណ
រត្ត	រ・ត・្・ត
ទីឃរត្ត	ទ・ី・ឃ・រ・ត・្・ត
អឌ្ឍរត្ត	អ・ឌ・្・ឍ・រ・ត・្・ត
រត្ត—	រ・ត・្・ត・—
រត្តញ្ញូ	រ・ត・្・ត・ញ・្・ញ・ូ
រត្តិកាល	រ・ត・្・ត・ិ・ក・ា・ល
រត្តិចរ	រ・ត・្・ត・ិ・ច・រ
រត្តិច្ឆេទ	រ・ត・្・ត・ិ・ច・្・ឆ・េ・ទ
រត្តិន្ទិព	រ・ត・្・ត・ិ・ន・្・ទ・ិ・ព
រត្តិភាគ	រ・ត・្・ត・ិ・ភ・ា・គ
រត្តុប្បល	រ・ត・្・ត・ុ・ប・្・ប・ល
រន្ធកសត្ត	រ・ន・្・ធ・ក・ស・ត・្・ត
រមាស់ចិត្ត	រ・ម・ា・ស・់・ច・ិ・ត・្・ត
រលកចិត្ត	រ・ល・ក・ច・ិ・ត・្・ត
រសាយចិត្ត	រ・ស・ា・យ・ច・ិ・ត・្・ត
រស្សកសត្ត	រ・ស・្・ស・ក・ស・ត・្・ត
រហស្សមិត្ត	រ・ហ・ស・្・ស・ម・ិ・ត・្・ត
រអាមចិត្ត	រ・អ・ា・ម・ច・ិ・ត・្・ត
ចិត្តរាក់	ច・ិ・ត・្・ត・រ・ា・ក・់
រាគចិត្ត	រ・ា・គ・ច・ិ・ត・្・ត
រាជនត្តា	រ・ា・ជ・ន・ត・្・ត・ា
រាជបរិវត្តន៍	រ・ា・ជ・ប・រ・ិ・វ・ត・្・ត・ន・៍
រាជប្បញ្ញត្តិ	រ・ា・ជ・ប・្・ប・ញ・្・ញ・ត・្・ត・ិ
រាជប្រវត្តិ	រ・ា・ជ・ប・្・រ・វ・ត・្・ត・ិ
រាជព្រឹត្តិ	រ・ា・ជ・ព・្・រ・ឹ・ត・្・ត・ិ
រាជមិត្ត	រ・ា・ជ・ម・ិ・ត・្・ត
រាជសម្ពន្ធមិត្ត	រ・ា・ជ・ស・ម・្・ព・ន・្・ធ・ម・ិ・ត・្・ត
រាជាយុត្តកសភា	រ・ា・ជ・ា・យ・ុ・ត・្・ត・ក・ស・ភ・ា
រាជាយុត្តកាធិបតី	រ・ា・ជ・ា・យ・ុ・ត・្・ត・ក・ា・ធ・ិ・ប・ត・ី
រាជាយុត្តកៈ	រ・ា・ជ・ា・យ・ុ・ត・្・ត・ក・ៈ
រាជ្យសម្បត្តិ	រ・ា・ជ・្・យ・ស・ម・្・ប・ត・្・ត・ិ
រាជសម្បត្តិ	រ・ា・ជ・ស・ម・្・ប・ត・្・ត・ិ
រិត្តភាព	រ・ិ・ត・្・ត・ភ・ា・ព
រីកចិត្ត	រ・ី・ក・ច・ិ・ត・្・ត
ចិត្តរឹល	ច・ិ・ត・្・ត・រ・ឹ・ល
រូបបរិវត្ត	រ・ូ・ប・ប・រ・ិ・វ・ត・្・ត
រូបបរិវត្តន៍	រ・ូ・ប・ប・រ・ិ・វ・ត・្・ត・ន・៍
រូបិយាណត្តិ	រ・ូ・ប・ិ・យ・ា・ណ・ត・្・ត・ិ
ចិត្តរួញ	ច・ិ・ត・្・ត・រ・ួ・ញ
រួញចិត្ត	រ・ួ・ញ・ច・ិ・ត・្・ត
រួមចិត្ត	រ・ួ・ម・ច・ិ・ត・្・ត
រោសចិត្ត	រ・ោ・ស・ច・ិ・ត・្・ត
ចិត្តរំជួល	ច・ិ・ត・្・ត・រ・ំ・ជ・ួ・ល
ចិត្តរំភើប	ច・ិ・ត・្・ត・រ・ំ・ភ・ើ・ប
រំភើបចិត្ត	រ・ំ・ភ・ើ・ប・ច・ិ・ត・្・ត
លក្ខណប្បញ្ញត្តិ	ល・ក・្・ខ・ណ・ប・្・ប・ញ・្・ញ・ត・្・ត・ិ
លក្ខណវិបត្តិ	ល・ក・្・ខ・ណ・វ・ិ・ប・ត・្・ត・ិ
លក្ខណសម្បត្តិ	ល・ក・្・ខ・ណ・ស・ម・្・ប・ត・្・ត・ិ
លក្ខណវិនយប្បញ្ញត្តិ	ល・ក・្・ខ・ណ・វ・ិ・ន・យ・ប・្・ប・ញ・្・ញ・ត・្・ត・ិ
លក្ខន្តិកប្បញ្ញត្តិ	ល・ក・្・ខ・ន・្・ត・ិ・ក・ប・្・ប・ញ・្・ញ・ត・្・ត・ិ
លឃុចិត្ត	ល・ឃ・ុ・ច・ិ・ត・្・ត
លទ្ធសម្បត្តិ	ល・ទ・្・ធ・ស・ម・្・ប・ត・្・ត・ិ
លហុចិត្ត	ល・ហ・ុ・ច・ិ・ត・្・ត
លហុកាបត្តិ	ល・ហ・ុ・ក・ា・ប・ត・្・ត・ិ
លាងចិត្ត	ល・ា・ង・ច・ិ・ត・្・ត
បុត្តលាភ	ប・ុ・ត・្・ត・ល・ា・ភ
លាមកសត្ត	ល・ា・ម・ក・ស・ត・្・ត
លិង្គព្រឹត្តិ	ល・ិ・ង・្・គ・ព・្・រ・ឹ・ត・្・ត・ិ
លុត្ត	ល・ុ・ត・្・ត
លុត្តបទ	ល・ុ・ត・្・ត・ប・ទ
លុត្តសមាស	ល・ុ・ត・្・ត・ស・ម・ា・ស
លួចចិត្ត	ល・ួ・ច・ច・ិ・ត・្・ត
លើកទឹកចិត្ត	ល・ើ・ក・ទ・ឹ・ក・ច・ិ・ត・្・ត
លេសមត្ត	ល・េ・ស・ម・ត・្・ត
លោកប្បត្តិ	ល・ោ・ក・ប・្・ប・ត・្・ត・ិ
លោកប្រវត្តិ	ល・ោ・ក・ប・្・រ・វ・ត・្・ត・ិ
លោកានុវត្តន៍	ល・ោ・ក・ា・ន・ុ・វ・ត・្・ត・ន・៍
លោកានុវត្តិ	ល・ោ・ក・ា・ន・ុ・វ・ត・្・ត・ិ
លោកុត្តរចិត្ត	ល・ោ・ក・ុ・ត・្・ត・រ・ច・ិ・ត・្・ត
លោកុត្តរចិត្ត	ល・ោ・ក・ុ・ត・្・ត・រ・ច・ិ・ត・្・ត
លោកុត្តរសម្បត្តិ	ល・ោ・ក・ុ・ត・្・ត・រ・ស・ម・្・ប・ត・្・ត・ិ
លោកុត្តរសម្បត្តិ	ល・ោ・ក・ុ・ត・្・ត・រ・ស・ម・្・ប・ត・្・ត・ិ
លោកុត្តរាភិសម័យ	ល・ោ・ក・ុ・ត・្・ត・រ・ា・ភ・ិ・ស・ម・័・យ
លោកុត្តរារិយមគ្គ	ល・ោ・ក・ុ・ត・្・ត・រ・ា・រ・ិ・យ・ម・គ・្・គ
លោកសម្បត្តិ	ល・ោ・ក・ស・ម・្・ប・ត・្・ត・ិ
លោកិយចិត្ត	ល・ោ・ក・ិ・យ・ច・ិ・ត・្・ត
លោកិយសត្ត	ល・ោ・ក・ិ・យ・ស・ត・្・ត
លោកុត្តរ	ល・ោ・ក・ុ・ត・្・ត・រ
លោកុត្តរធម៌	ល・ោ・ក・ុ・ត・្・ត・រ・ធ・ម・៌
លោកុត្តរប្បញ្ញា	ល・ោ・ក・ុ・ត・្・ត・រ・ប・្・ប・ញ・្・ញ・ា
លោភចិត្ត	ល・ោ・ភ・ច・ិ・ត・្・ត
ល្បះកត្តុ	ល・្・ប・ះ・ក・ត・្・ត・ុ
ល្ហើយចិត្ត	ល・្・ហ・ើ・យ・ច・ិ・ត・្・ត
ចិត្តល្អៀង	ច・ិ・ត・្・ត・ល・្・អ・ៀ・ង
វង្កមិត្ត	វ・ង・្・ក・ម・ិ・ត・្・ត
វង្វេងចិត្ត	វ・ង・្・វ・េ・ង・ច・ិ・ត・្・ត
ខត្តិយវង្ស	ខ・ត・្・ត・ិ・យ・វ・ង・្・ស
វចនមិត្ត	វ・ច・ន・ម・ិ・ត・្・ត
វចីបរមមិត្ត	វ・ច・ី・ប・រ・ម・ម・ិ・ត・្・ត
វណ្ណព្រឹត្ត	វ・ណ・្・ណ・ព・្・រ・ឹ・ត・្・ត
វណ្ណមត្ត	វ・ណ・្・ណ・ម・ត・្・ត
វណ្ណមត្តា	វ・ណ・្・ណ・ម・ត・្・ត・ា
វណ្ណសម្បត្តិ	វ・ណ・្・ណ・ស・ម・្・ប・ត・្・ត・ិ
វណ្ណយុត្ត	វ・ណ・្・ណ・យ・ុ・ត・្・ត
វត្ត	វ・ត・្・ត
មនុស្សមានវត្តល្អ	ម・ន・ុ・ស・្・ស・ម・ា・ន・វ・ត・្・ត・ល・្・អ
យកវត្តគ្រូ	យ・ក・វ・ត・្・ត・គ・្・រ・ូ
វត្តបទ	វ・ត・្・ត・ប・ទ
វត្តប្បដិវត្ត	វ・ត・្・ត・ប・្・ប・ដ・ិ・វ・ត・្・ត
វត្តប្បដិវត្ត	វ・ត・្・ត・ប・្・ប・ដ・ិ・វ・ត・្・ត
វត្តប្រតិបត្តិ	វ・ត・្・ត・ប・្・រ・ត・ិ・ប・ត・្・ត・ិ
វត្តប្រតិបត្តិ	វ・ត・្・ត・ប・្・រ・ត・ិ・ប・ត・្・ត・ិ
វត្តវតី	វ・ត・្・ត・វ・ត・ី
វត្តវន្ត	វ・ត・្・ត・វ・ន・្・ត
វត្តវន្តី	វ・ត・្・ត・វ・ន・្・ត・ី
វត្តសមាទាន	វ・ត・្・ត・ស・ម・ា・ទ・ា・ន
វត្តសម្បន្ន	វ・ត・្・ត・ស・ម・្・ប・ន・្・ន
វត្តសម្បន្នា	វ・ត・្・ត・ស・ម・្・ប・ន・្・ន・ា
សាលាវត្ត	ស・ា・ល・ា・វ・ត・្・ត
សិស្សធ្វើវត្ត	ស・ិ・ស・្・ស・ធ・្・វ・ើ・វ・ត・្・ត
វត្ត—	វ・ត・្・ត・—
វត្តនី	វ・ត・្・ត・ន・ី
វត្តពូជ	វ・ត・្・ត・ព・ូ・ជ
វត្តមាន	វ・ត・្・ត・ម・ា・ន
វត្តមាន	វ・ត・្・ត・ម・ា・ន
វត្តមានកាល	វ・ត・្・ត・ម・ា・ន・ក・ា・ល
វត្តមានា	វ・ត・្・ត・ម・ា・ន・ា
វប្បក្ខេត្ត	វ・ប・្・ប・ក・្・ខ・េ・ត・្・ត
វយបត្តិ	វ・យ・ប・ត・្・ត・ិ
វរមិត្ត	វ・រ・ម・ិ・ត・្・ត
វរចិត្ត	វ・រ・ច・ិ・ត・្・ត
វរោត្តម	វ・រ・ោ・ត・្・ត・ម
វល្លភមិត្ត	វ・ល・្・ល・ភ・ម・ិ・ត・្・ត
វសវត្តី	វ・ស・វ・ត・្・ត・ី
វាក្យបរិវត្តន៍	វ・ា・ក・្・យ・ប・រ・ិ・វ・ត・្・ត・ន・៍
វាលគ្គមត្ត	វ・ា・ល・គ・្・គ・ម・ត・្・ត
វាសិតចិត្ត	វ・ា・ស・ិ・ត・ច・ិ・ត・្・ត
វិកតិកត្តា	វ・ិ・ក・ត・ិ・ក・ត・្・ត・ា
វិកសិតចិត្ត	វ・ិ・ក・ស・ិ・ត・ច・ិ・ត・្・ត
វិក្ខិត្តចិត្ត	វ・ិ・ក・្・ខ・ិ・ត・្・ត・ច・ិ・ត・្・ត
វិក្ខិត្តចិត្ត	វ・ិ・ក・្・ខ・ិ・ត・្・ត・ច・ិ・ត・្・ត
វិក្ខេបចិត្ត	វ・ិ・ក・្・ខ・េ・ប・ច・ិ・ត・្・ត
វិចចិត្ត	វ・ិ・ច・ច・ិ・ត・្・ត
វិចិកិច្ឆាសម្បយុត្ត	វ・ិ・ច・ិ・ក・ិ・ច・្・ឆ・ា・ស・ម・្・ប・យ・ុ・ត・្・ត
វិចិត្តកម្ម	វ・ិ・ច・ិ・ត・្・ត・ក・ម・្・ម
វិចិត្តការ	វ・ិ・ច・ិ・ត・្・ត・ក・ា・រ
វិចិត្តការ្យ	វ・ិ・ច・ិ・ត・្・ត・ក・ា・រ・្・យ
វិចិត្តភណ្ឌ	វ・ិ・ច・ិ・ត・្・ត・ភ・ណ・្・ឌ
វិជ្ជមានប្បញ្ញត្តិ	វ・ិ・ជ・្・ជ・ម・ា・ន・ប・្・ប・ញ・្・ញ・ត・្・ត・ិ
វិញ្ញត្តិ	វ・ិ・ញ・្・ញ・ត・្・ត・ិ
វិញ្ញត្តិកថា	វ・ិ・ញ・្・ញ・ត・្・ត・ិ・ក・ថ・ា
វិញ្ញត្តិកម្ម	វ・ិ・ញ・្・ញ・ត・្・ត・ិ・ក・ម・្・ម
វិញ្ញត្តិវប្បធម៌	វ・ិ・ញ・្・ញ・ត・្・ត・ិ・វ・ប・្・ប・ធ・ម・៌
វិត្តៈ	វ・ិ・ត・្・ត・ៈ
វិត្តន្តរាយ	វ・ិ・ត・្・ត・ន・្・ត・រ・ា・យ
វិត្តលាភ	វ・ិ・ត・្・ត・ល・ា・ភ
វិត្តវិនាស	វ・ិ・ត・្・ត・វ・ិ・ន・ា・ស
វិនយបញ្ញត្តិ	វ・ិ・ន・យ・ប・ញ・្・ញ・ត・្・ត・ិ
វិនីតចិត្ត	វ・ិ・ន・ី・ត・ច・ិ・ត・្・ត
មិត្តវិន្ទ	ម・ិ・ត・្・ត・វ・ិ・ន・្・ទ
វិបត្តិ	វ・ិ・ប・ត・្・ត・ិ
វិបត្តិការណ៍	វ・ិ・ប・ត・្・ត・ិ・ក・ា・រ・ណ・៍
វិបត្តិមូល	វ・ិ・ប・ត・្・ត・ិ・ម・ូ・ល
វិបត្តិហេតុ	វ・ិ・ប・ត・្・ត・ិ・ហ・េ・ត・ុ
វិបាកចិត្ត	វ・ិ・ប・ា・ក・ច・ិ・ត・្・ត
វិប្បដិសារចិត្ត	វ・ិ・ប・្・ប・ដ・ិ・ស・ា・រ・ច・ិ・ត・្・ត
បុត្តវិប្បយោគ	ប・ុ・ត・្・ត・វ・ិ・ប・្・ប・យ・ោ・គ
វិប្រតិបត្តិ	វ・ិ・ប・្・រ・ត・ិ・ប・ត・្・ត・ិ
វិព្ភន្តចិត្ត	វ・ិ・ព・្・ភ・ន・្・ត・ច・ិ・ត・្・ត
វិភត្តិ	វ・ិ・ភ・ត・្・ត・ិ
វិភត្តិវិបល្លាស	វ・ិ・ភ・ត・្・ត・ិ・វ・ិ・ប・ល・្・ល・ា・ស
វិមលចិត្ត	វ・ិ・ម・ល・ច・ិ・ត・្・ត
វិមុត្ត	វ・ិ・ម・ុ・ត・្・ត
វិមុត្តចិត្ត	វ・ិ・ម・ុ・ត・្・ត・ច・ិ・ត・្・ត
វិមុត្តចិត្ត	វ・ិ・ម・ុ・ត・្・ត・ច・ិ・ត・្・ត
វិមុត្តិ	វ・ិ・ម・ុ・ត・្・ត・ិ
វិមុត្តិញ្ញាណទស្សនៈ	វ・ិ・ម・ុ・ត・្・ត・ិ・ញ・្・ញ・ា・ណ・ទ・ស・្・ស・ន・ៈ
វិមុត្តិសុខ	វ・ិ・ម・ុ・ត・្・ត・ិ・ស・ុ・ខ
វិរាគចិត្ត	វ・ិ・រ・ា・គ・ច・ិ・ត・្・ត
វិវត្ត	វ・ិ・វ・ត・្・ត
វិវត្តន៍	វ・ិ・វ・ត・្・ត・ន・៍
វិវិត្ត	វ・ិ・វ・ិ・ត・្・ត
វិវិត្តដ្ឋាន	វ・ិ・វ・ិ・ត・្・ត・ដ・្・ឋ・ា・ន
ចិត្តវិវេក	ច・ិ・ត・្・ត・វ・ិ・វ・េ・ក
វិសមចិត្ត	វ・ិ・ស・ម・ច・ិ・ត・្・ត
វិសមត្ត	វ・ិ・ស・ម・ត・្・ត
វិសមានចិត្ត	វ・ិ・ស・ម・ា・ន・ច・ិ・ត・្・ត
វិសយប្បវត្តិ	វ・ិ・ស・យ・ប・្・ប・វ・ត・្・ត・ិ
វិសយប្រវត្តិ	វ・ិ・ស・យ・ប・្・រ・វ・ត・្・ត・ិ
វិសុទ្ធចិត្ត	វ・ិ・ស・ុ・ទ・្・ធ・ច・ិ・ត・្・ត
វិស្សាសិកមិត្ត	វ・ិ・ស・្・ស・ា・ស・ិ・ក・ម・ិ・ត・្・ត
វីថិចិត្ត	វ・ី・ថ・ិ・ច・ិ・ត・្・ត
វីរិយសម្បត្តិ	វ・ី・រ・ិ・យ・ស・ម・្・ប・ត・្・ត・ិ
វុត្ត	វ・ុ・ត・្・ត
វុត្តការណ៍	វ・ុ・ត・្・ត・ក・ា・រ・ណ・៍
វុត្តដ្ឋាន	វ・ុ・ត・្・ត・ដ・្・ឋ・ា・ន
វុត្តនិយម	វ・ុ・ត・្・ត・ន・ិ・យ・ម
វុត្តនិយាម	វ・ុ・ត・្・ត・ន・ិ・យ・ា・ម
វុត្តន័យ	វ・ុ・ត・្・ត・ន・័・យ
វុត្តប្បមាណ	វ・ុ・ត・្・ត・ប・្・ប・ម・ា・ណ
វុត្តភាព	វ・ុ・ត・្・ត・ភ・ា・ព
វុត្តវាចា	វ・ុ・ត・្・ត・វ・ា・ច・ា
វុត្តវាទ	វ・ុ・ត・្・ត・វ・ា・ទ
វុត្តានុក្រម	វ・ុ・ត・្・ត・ា・ន・ុ・ក・្・រ・ម
វុត្តពីជ	វ・ុ・ត・្・ត・ព・ី・ជ
វុត្តពូជ	វ・ុ・ត・្・ត・ព・ូ・ជ
វុត្តិ	វ・ុ・ត・្・ត・ិ
វុត្តិកម្ម	វ・ុ・ត・្・ត・ិ・ក・ម・្・ម
វុត្តិភាព	វ・ុ・ត・្・ត・ិ・ភ・ា・ព
វុត្តោទ័យ	វ・ុ・ត・្・ត・ោ・ទ・័・យ
វូបសន្តចិត្ត	វ・ូ・ប・ស・ន・្・ត・ច・ិ・ត・្・ត
វេចទុកតែក្នុងចិត្ត	វ・េ・ច・ទ・ុ・ក・ត・ែ・ក・្・ន・ុ・ង・ច・ិ・ត・្・ត
វេជ្ជប្បញ្ញត្តិ	វ・េ・ជ・្・ជ・ប・្・ប・ញ・្・ញ・ត・្・ត・ិ
វេទនានុវត្តន៍	វ・េ・ទ・ន・ា・ន・ុ・វ・ត・្・ត・ន・៍
វេបចិត្តិ	វ・េ・ប・ច・ិ・ត・្・ត・ិ
សកនិរុត្តិ	ស・ក・ន・ិ・រ・ុ・ត・្・ត・ិ
សកាយនិរុត្តិ	ស・ក・ា・យ・ន・ិ・រ・ុ・ត・្・ត・ិ
សក្យបុត្តិយ៍	ស・ក・្・យ・ប・ុ・ត・្・ត・ិ・យ・៍
សគោត្ត	ស・គ・ោ・ត・្・ត
សង្កិលេសិកចិត្ត	ស・ង・្・ក・ិ・ល・េ・ស・ិ・ក・ច・ិ・ត・្・ត
សង្កៀរចិត្ត	ស・ង・្・ក・ៀ・រ・ច・ិ・ត・្・ត
ចិត្តសង្ខារ	ច・ិ・ត・្・ត・ស・ង・្・ខ・ា・រ
សង្ខិត្ត	ស・ង・្・ខ・ិ・ត・្・ត
សង្ខិត្តកថា	ស・ង・្・ខ・ិ・ត・្・ត・ក・ថ・ា
សង្ខិត្តចិត្ត	ស・ង・្・ខ・ិ・ត・្・ត・ច・ិ・ត・្・ត
សង្ខិត្តចិត្ត	ស・ង・្・ខ・ិ・ត・្・ត・ច・ិ・ត・្・ត
សង្ខិត្តន័យ	ស・ង・្・ខ・ិ・ត・្・ត・ន・័・យ
សង្ខោភចិត្ត	ស・ង・្・ខ・ោ・ភ・ច・ិ・ត・្・ត
សង្គមប្រវត្តិ	ស・ង・្・គ・ម・ប・្・រ・វ・ត・្・ត・ិ
សង្គីតិប្រវត្តិ	ស・ង・្・គ・ី・ត・ិ・ប・្・រ・វ・ត・្・ត・ិ
សង្ឃភត្ត	ស・ង・្・ឃ・ភ・ត・្・ត
សង្ឃាណត្តិ	ស・ង・្・ឃ・ា・ណ・ត・្・ត・ិ
សង្រ្គាមចិត្តសាស្រ្ត	ស・ង・្・រ・្・គ・ា・ម・ច・ិ・ត・្・ត・ស・ា・ស・្・រ・្・ត
សចិត្តកៈ	ស・ច・ិ・ត・្・ត・ក・ៈ
សចិត្តកកម្ម	ស・ច・ិ・ត・្・ត・ក・ក・ម・្・ម
សចិត្តកទោស	ស・ច・ិ・ត・្・ត・ក・ទ・ោ・ស
សចិត្តកាបត្តិ	ស・ច・ិ・ត・្・ត・ក・ា・ប・ត・្・ត・ិ
សចិត្តកាបត្តិ	ស・ច・ិ・ត・្・ត・ក・ា・ប・ត・្・ត・ិ
សញ្ញាវិបត្តិ	ស・ញ・្・ញ・ា・វ・ិ・ប・ត・្・ត・ិ
សតបត្ត	ស・ត・ប・ត・្・ត
សត្តប័ត្រ	ស・ត・្・ត・ប・័・ត・្・រ
សតបទីសត្ត	ស・ត・ប・ទ・ី・ស・ត・្・ត
សតេកិច្ឆាបត្តិ	ស・ត・េ・ក・ិ・ច・្・ឆ・ា・ប・ត・្・ត・ិ
សត្ត	ស・ត・្・ត
សត្តក្ខ័យ	ស・ត・្・ត・ក・្・ខ・័・យ
សត្តគុណ	ស・ត・្・ត・គ・ុ・ណ
សត្តសញ្ញា	ស・ត・្・ត・ស・ញ・្・ញ・ា
សត្តសារ	ស・ត・្・ត・ស・ា・រ
សត្ត	ស・ត・្・ត
សត្តខណ្ឌ	ស・ត・្・ត・ខ・ណ・្・ឌ
សត្តទិន	ស・ត・្・ត・ទ・ិ・ន
សត្តបរិភណ្ឌ	ស・ត・្・ត・ប・រ・ិ・ភ・ណ・្・ឌ
សត្តពិធ	ស・ត・្・ត・ព・ិ・ធ
សត្តភូមិក	ស・ត・្・ត・ភ・ូ・ម・ិ・ក
សត្តមាស	ស・ត・្・ត・ម・ា・ស
សត្តវារៈ	ស・ត・្・ត・វ・ា・រ・ៈ
សត្តាហករណីយកិច្ច	ស・ត・្・ត・ា・ហ・ក・រ・ណ・ី・យ・ក・ិ・ច・្・ច
សត្តាហកាលិក	ស・ត・្・ត・ា・ហ・ក・ា・ល・ិ・ក
សត្តាហកិច្ច	ស・ត・្・ត・ា・ហ・ក・ិ・ច・្・ច
សត្តាហៈ	ស・ត・្・ត・ា・ហ・ៈ
សត្តកោណ	ស・ត・្・ត・ក・ោ・ណ
សត្តកោណនិយ័ត	ស・ត・្・ត・ក・ោ・ណ・ន・ិ・យ・័・ត
សត្តឃាត	ស・ត・្・ត・ឃ・ា・ត
ទីសត្តឃាត	ទ・ី・ស・ត・្・ត・ឃ・ា・ត
សត្តឃាតកៈ	ស・ត・្・ត・ឃ・ា・ត・ក・ៈ
សត្តឃាតដ្ឋាន	ស・ត・្・ត・ឃ・ា・ត・ដ・្・ឋ・ា・ន
សត្តឃាតិកា	ស・ត・្・ត・ឃ・ា・ត・ិ・ក・ា
សត្តនាយក	ស・ត・្・ត・ន・ា・យ・ក
សត្តនិករ	ស・ត・្・ត・ន・ិ・ក・រ
សត្តនិកាយ	ស・ត・្・ត・ន・ិ・ក・ា・យ
សត្តបង្ក័ជ	ស・ត・្・ត・ប・ង・្・ក・័・ជ
សត្តបុស្ប	ស・ត・្・ត・ប・ុ・ស・្・ប
សត្តបុស្យ	ស・ត・្・ត・ប・ុ・ស・្・យ
សត្តបុស្ស	ស・ត・្・ត・ប・ុ・ស・្・ស
សត្តប្បករណាភិធម្ម	ស・ត・្・ត・ប・្・ប・ក・រ・ណ・ា・ភ・ិ・ធ・ម・្・ម
សត្តប្បករណ៍	ស・ត・្・ត・ប・្・ប・ក・រ・ណ・៍
សត្តពារ	ស・ត・្・ត・ព・ា・រ
សត្តភូតគាម	ស・ត・្・ត・ភ・ូ・ត・គ・ា・ម
សត្តម	ស・ត・្・ត・ម
សត្តមភូមិ	ស・ត・្・ត・ម・ភ・ូ・ម・ិ
សត្តមវារៈ	ស・ត・្・ត・ម・វ・ា・រ・ៈ
សត្តមទិន	ស・ត・្・ត・ម・ទ・ិ・ន
សត្តមហាឋាន	ស・ត・្・ត・ម・ហ・ា・ឋ・ា・ន
សត្តមី	ស・ត・្・ត・ម・ី
សត្តមី	ស・ត・្・ត・ម・ី
សត្តមី	ស・ត・្・ត・ម・ី
សត្តមីវិភត្តិនាម	ស・ត・្・ត・ម・ី・វ・ិ・ភ・ត・្・ត・ិ・ន・ា・ម
សត្តមីវិភត្តិនាម	ស・ត・្・ត・ម・ី・វ・ិ・ភ・ត・្・ត・ិ・ន・ា・ម
សត្តលោក	ស・ត・្・ត・ល・ោ・ក
សត្តវង្កជាតិ	ស・ត・្・ត・វ・ង・្・ក・ជ・ា・ត・ិ
សត្តវិជ្ជា	ស・ត・្・ត・វ・ិ・ជ・្・ជ・ា
សត្តវិទ្យា	ស・ត・្・ត・វ・ិ・ទ・្・យ・ា
សទ្ធាចិត្ត	ស・ទ・្・ធ・ា・ច・ិ・ត・្・ត
សទ្ធាធិមុត្ត	ស・ទ・្・ធ・ា・ធ・ិ・ម・ុ・ត・្・ត
សទ្ធាសម្បយុត្ត	ស・ទ・្・ធ・ា・ស・ម・្・ប・យ・ុ・ត・្・ត
សទ្ធិវិហារិកវត្ត	ស・ទ・្・ធ・ិ・វ・ិ・ហ・ា・រ・ិ・ក・វ・ត・្・ត
សទ្ធឹវិហារិកវត្ត	ស・ទ・្・ធ・ឹ・វ・ិ・ហ・ា・រ・ិ・ក・វ・ត・្・ត
សន្តាបចិត្ត	ស・ន・្・ត・ា・ប・ច・ិ・ត・្・ត
សន្ថវមិត្ត	ស・ន・្・ថ・វ・ម・ិ・ត・្・ត
សន្ទិដ្ឋមិត្ត	ស・ន・្・ទ・ិ・ដ・្・ឋ・ម・ិ・ត・្・ត
សន្ទេហចិត្ត	ស・ន・្・ទ・េ・ហ・ច・ិ・ត・្・ត
សន្ធានមិត្ត	ស・ន・្・ធ・ា・ន・ម・ិ・ត・្・ត
សបត្តជន	ស・ប・ត・្・ត・ជ・ន
សប្បាយចិត្ត	ស・ប・្・ប・ា・យ・ច・ិ・ត・្・ត
សព្វយុត្ត	ស・ព・្・វ・យ・ុ・ត・្・ត
សព្វរោគវិនិមុត្ត	ស・ព・្・វ・រ・ោ・គ・វ・ិ・ន・ិ・ម・ុ・ត・្・ត
សព្វរោគវិមុត្ត	ស・ព・្・វ・រ・ោ・គ・វ・ិ・ម・ុ・ត・្・ត
សភាគាបត្តិ	ស・ភ・ា・គ・ា・ប・ត・្・ត・ិ
សមគោត្ត	ស・ម・គ・ោ・ត・្・ត
សមចិត្ត	ស・ម・ច・ិ・ត・្・ត
សមគ្គចិត្ត	ស・ម・គ・្・គ・ច・ិ・ត・្・ត
សមណប្បដិបត្តិ	ស・ម・ណ・ប・្・ប・ដ・ិ・ប・ត・្・ត・ិ
ស្រមណប្រតិបត្តិ	ស・្・រ・ម・ណ・ប・្・រ・ត・ិ・ប・ត・្・ត・ិ
សមណសក្ដិទីរាជាគណៈខាងគណៈធម្មយុត្តិកនិកាយ	ស・ម・ណ・ស・ក・្・ដ・ិ・ទ・ី・រ・ា・ជ・ា・គ・ណ・ៈ・ខ・ា・ង・គ・ណ・ៈ・ធ・ម・្・ម・យ・ុ・ត・្・ត・ិ・ក・ន・ិ・ក・ា・យ
សមណុត្តមាភិសេក	ស・ម・ណ・ុ・ត・្・ត・ម・ា・ភ・ិ・ស・េ・ក
សមត្ថចិត្ត	ស・ម・ត・្・ថ・ច・ិ・ត・្・ត
សមាធិចិត្ត	ស・ម・ា・ធ・ិ・ច・ិ・ត・្・ត
សមានគោត្ត	ស・ម・ា・ន・គ・ោ・ត・្・ត
សមានចិត្ត	ស・ម・ា・ន・ច・ិ・ត・្・ត
សមាបត្តិ	ស・ម・ា・ប・ត・្・ត・ិ
និរោធសមាបត្តិ	ន・ិ・រ・ោ・ធ・ស・ម・ា・ប・ត・្・ត・ិ
សមាហិតចិត្ត	ស・ម・ា・ហ・ិ・ត・ច・ិ・ត・្・ត
ចិត្តសមុដ្ឋាន	ច・ិ・ត・្・ត・ស・ម・ុ・ដ・្・ឋ・ា・ន
សម្បត្តិ	ស・ម・្・ប・ត・្・ត・ិ
សម្បត្តិសម្បូណ៌	ស・ម・្・ប・ត・្・ត・ិ・ស・ម・្・ប・ូ・ណ・៌
សម្បត្តិភត្តតិរ៉ែ	ស・ម・្・ប・ត・្・ត・ិ・ភ・ត・្・ត・ត・ិ・រ・៉・ែ
សម្បត្តិភត្តតិរ៉ែ	ស・ម・្・ប・ត・្・ត・ិ・ភ・ត・្・ត・ត・ិ・រ・៉・ែ
សម្បយុត្ត	ស・ម・្・ប・យ・ុ・ត・្・ត
សម្បរិវត្តនភាព	ស・ម・្・ប・រ・ិ・វ・ត・្・ត・ន・ភ・ា・ព
សម្បរិវត្តន៍	ស・ម・្・ប・រ・ិ・វ・ត・្・ត・ន・៍
សម្បរិវត្តនាការ	ស・ម・្・ប・រ・ិ・វ・ត・្・ត・ន・ា・ក・ា・រ
សម្បុកសម្បត្តិ	ស・ម・្・ប・ុ・ក・ស・ម・្・ប・ត・្・ត・ិ
សម្ពន្ធមិត្ត	ស・ម・្・ព・ន・្・ធ・ម・ិ・ត・្・ត
សម្ពាធចិត្ត	ស・ម・្・ព・ា・ធ・ច・ិ・ត・្・ត
សម្ភត្តមិត្ត	ស・ម・្・ភ・ត・្・ត・ម・ិ・ត・្・ត
សម្ភត្តមិត្ត	ស・ម・្・ភ・ត・្・ត・ម・ិ・ត・្・ត
សម្ភាវិតចិត្ត	ស・ម・្・ភ・ា・វ・ិ・ត・ច・ិ・ត・្・ត
សម្ភាវិតមិត្ត	ស・ម・្・ភ・ា・វ・ិ・ត・ម・ិ・ត・្・ត
សម្ភិតចិត្ត	ស・ម・្・ភ・ិ・ត・ច・ិ・ត・្・ត
សម្មជ្ជនវត្ត	ស・ម・្・ម・ជ・្・ជ・ន・វ・ត・្・ត
សម្មាបដិបត្តិ	ស・ម・្・ម・ា・ប・ដ・ិ・ប・ត・្・ត・ិ
សម្រេចចិត្ត	ស・ម・្・រ・េ・ច・ច・ិ・ត・្・ត
សលាកបរិវត្តន៍	ស・ល・ា・ក・ប・រ・ិ・វ・ត・្・ត・ន・៍
សលាកភត្ត	ស・ល・ា・ក・ភ・ត・្・ត
សលាកានុវត្តន៍	ស・ល・ា・ក・ា・ន・ុ・វ・ត・្・ត・ន・៍
សសោះអន្ទងយោងចិត្ត	ស・ស・ោ・ះ・អ・ន・្・ទ・ង・យ・ោ・ង・ច・ិ・ត・្・ត
សហបុត្ត	ស・ហ・ប・ុ・ត・្・ត
សហប្រតិបត្តិការ	ស・ហ・ប・្・រ・ត・ិ・ប・ត・្・ត・ិ・ក・ា・រ
សហវត្ត	ស・ហ・វ・ត・្・ត
សហស្សនេត្ត	ស・ហ・ស・្・ស・ន・េ・ត・្・ត
សាតចិត្ត	ស・ា・ត・ច・ិ・ត・្・ត
សាធុព្រឹត្តិ	ស・ា・ធ・ុ・ព・្・រ・ឹ・ត・្・ត・ិ
សាមគ្គីមិត្ត	ស・ា・ម・គ・្・គ・ី・ម・ិ・ត・្・ត
សាមញ្ញប្បដិបត្តិ	ស・ា・ម・ញ・្・ញ・ប・្・ប・ដ・ិ・ប・ត・្・ត・ិ
សាមីចិបដិបត្តិ	ស・ា・ម・ី・ច・ិ・ប・ដ・ិ・ប・ត・្・ត・ិ
សាមីចិវត្ត	ស・ា・ម・ី・ច・ិ・វ・ត・្・ត
សាយភត្ត	ស・ា・យ・ភ・ត・្・ត
សារប្បវត្តិ	ស・ា・រ・ប・្・ប・វ・ត・្・ត・ិ
សារពើយុត្ត	ស・ា・រ・ព・ើ・យ・ុ・ត・្・ត
សារីបុត្ត	ស・ា・រ・ី・ប・ុ・ត・្・ត
សាលាមត្តេយ្យសិក្សា	ស・ា・ល・ា・ម・ត・្・ត・េ・យ・្・យ・ស・ិ・ក・្・ស・ា
សាវិត្តិសាស្ត្រ	ស・ា・វ・ិ・ត・្・ត・ិ・ស・ា・ស・្・ត・្・រ
សាសនប្បដិបត្តិ	ស・ា・ស・ន・ប・្・ប・ដ・ិ・ប・ត・្・ត・ិ
សាសនប្បវត្តិ	ស・ា・ស・ន・ប・្・ប・វ・ត・្・ត・ិ
សាសនប្រតិបត្តិ	ស・ា・ស・ន・ប・្・រ・ត・ិ・ប・ត・្・ត・ិ
សាសនប្រវត្តិ	ស・ា・ស・ន・ប・្・រ・វ・ត・្・ត・ិ
សាសនសម្បត្តិ	ស・ា・ស・ន・ស・ម・្・ប・ត・្・ត・ិ
សិត្តាប៊ីត	ស・ិ・ត・្・ត・ា・ប・៊・ី・ត
សិត្តាបៃ	ស・ិ・ត・្・ត・ា・ប・ៃ
សិថិលមិត្ត	ស・ិ・ថ・ិ・ល・ម・ិ・ត・្・ត
សិនិទ្ធមិត្ត	ស・ិ・ន・ិ・ទ・្・ធ・ម・ិ・ត・្・ត
សិនេហចិត្ត	ស・ិ・ន・េ・ហ・ច・ិ・ត・្・ត
សិនេហមិត្ត	ស・ិ・ន・េ・ហ・ម・ិ・ត・្・ត
សិរីសម្បត្តិ	ស・ិ・រ・ី・ស・ម・្・ប・ត・្・ត・ិ
សិរឹសបសត្ត	ស・ិ・រ・ឹ・ស・ប・ស・ត・្・ត
សិវក្ខេត្ត	ស・ិ・វ・ក・្・ខ・េ・ត・្・ត
សិស្សវត្ត	ស・ិ・ស・្・ស・វ・ត・្・ត
សីតលចិត្ត	ស・ី・ត・ល・ច・ិ・ត・្・ត
និមិត្តសីមា	ន・ិ・ម・ិ・ត・្・ត・ស・ី・ម・ា
សីមានិមិត្ត	ស・ី・ម・ា・ន・ិ・ម・ិ・ត・្・ត
សីលវិបត្តិ	ស・ី・ល・វ・ិ・ប・ត・្・ត・ិ
សីលសម្បត្តិ	ស・ី・ល・ស・ម・្・ប・ត・្・ត・ិ
សុខចិត្ត	ស・ុ・ខ・ច・ិ・ត・្・ត
សុខុមសត្ត	ស・ុ・ខ・ុ・ម・ស・ត・្・ត
សុចរិតយុត្តិធម៌	ស・ុ・ច・រ・ិ・ត・យ・ុ・ត・្・ត・ិ・ធ・ម・៌
សុចិត្តា	ស・ុ・ច・ិ・ត・្・ត・ា
សុ.ចិ.បុ.លិ.វិនិមុត្ត	ស・ុ・.・ច・ិ・.・ប・ុ・.・ល・ិ・.・វ・ិ・ន・ិ・ម・ុ・ត・្・ត
សុជាតបុត្ត	ស・ុ・ជ・ា・ត・ប・ុ・ត・្・ត
សុត្តន្តបិដក	ស・ុ・ត・្・ត・ន・្・ត・ប・ិ・ដ・ក
សុត្តីយភាព	ស・ុ・ត・្・ត・ី・យ・ភ・ា・ព
សុទន្តចិត្ត	ស・ុ・ទ・ន・្・ត・ច・ិ・ត・្・ត
សុទន្តសត្ត	ស・ុ・ទ・ន・្・ត・ស・ត・្・ត
សុទ្ធចិត្ត	ស・ុ・ទ・្・ធ・ច・ិ・ត・្・ត
សុធាមត្តិកា	ស・ុ・ធ・ា・ម・ត・្・ត・ិ・ក・ា
សុន្ទរសម្បត្តិ	ស・ុ・ន・្・ទ・រ・ស・ម・្・ប・ត・្・ត・ិ
សុបិននិមិត្ត	ស・ុ・ប・ិ・ន・ន・ិ・ម・ិ・ត・្・ត
សុពចមិត្ត	ស・ុ・ព・ច・ម・ិ・ត・្・ត
សុភនិមិត្ត	ស・ុ・ភ・ន・ិ・ម・ិ・ត・្・ត
សុភរបុត្ត	ស・ុ・ភ・រ・ប・ុ・ត・្・ត
សុមេធកុលបុត្ត	ស・ុ・ម・េ・ធ・ក・ុ・ល・ប・ុ・ត・្・ត
សុរាមត្ត	ស・ុ・រ・ា・ម・ត・្・ត
សុរាមត្តា	ស・ុ・រ・ា・ម・ត・្・ត・ា
សុរិយគោត្ត	ស・ុ・រ・ិ・យ・គ・ោ・ត・្・ត
សុរិយទេវបុត្ត	ស・ុ・រ・ិ・យ・ទ・េ・វ・ប・ុ・ត・្・ត
សុលភសម្បត្តិ	ស・ុ・ល・ភ・ស・ម・្・ប・ត・្・ត・ិ
សូកចិត្ត	ស・ូ・ក・ច・ិ・ត・្・ត
សូរចិត្ត	ស・ូ・រ・ច・ិ・ត・្・ត
សេដ្ឋីបុត្ត	ស・េ・ដ・្・ឋ・ី・ប・ុ・ត・្・ត
សេតច្ឆត្ត	ស・េ・ត・ច・្・ឆ・ត・្・ត
សោតាបត្តិមគ្គ	ស・ោ・ត・ា・ប・ត・្・ត・ិ・ម・គ・្・គ
សំយុងចិត្ត	ស・ំ・យ・ុ・ង・ច・ិ・ត・្・ត
សំយុត្តស្រៈ	ស・ំ・យ・ុ・ត・្・ត・ស・្・រ・ៈ
សំសេទជសត្ត	ស・ំ・ស・េ・ទ・ជ・ស・ត・្・ត
មិនស្កៀបចិត្ត	ម・ិ・ន・ស・្・ក・ៀ・ប・ច・ិ・ត・្・ត
មិនស្កាំចិត្ត	ម・ិ・ន・ស・្・ក・ា・ំ・ច・ិ・ត・្・ត
ស្កាំចិត្ត	ស・្・ក・ា・ំ・ច・ិ・ត・្・ត
ចិត្តស្ងប់	ច・ិ・ត・្・ត・ស・្・ង・ប・់
ស្ងប់ចិត្ត	ស・្・ង・ប・់・ច・ិ・ត・្・ត
ស្ងួនចិត្ត	ស・្・ង・ួ・ន・ច・ិ・ត・្・ត
ស្រឡាញ់ខ្លួនត្រូវស្ងួនចំណី ស្រឡាញ់ស្រីត្រូវថ្នមចិត្ត	ស・្・រ・ឡ・ា・ញ・់・ខ・្・ល・ួ・ន・ត・្・រ・ូ・វ・ស・្・ង・ួ・ន・ច・ំ・ណ・ី・ ・ស・្・រ・ឡ・ា・ញ・់・ស・្・រ・ី・ត・្・រ・ូ・វ・ថ・្・ន・ម・ច・ិ・ត・្・ត
ស្ដារចិត្ត	ស・្・ដ・ា・រ・ច・ិ・ត・្・ត
ស្ថិរចិត្ត	ស・្・ថ・ិ・រ・ច・ិ・ត・្・ត
ស្ទាបចិត្តមើល	ស・្・ទ・ា・ប・ច・ិ・ត・្・ត・ម・ើ・ល
ស្ទើរចិត្ត	ស・្・ទ・ើ・រ・ច・ិ・ត・្・ត
ស្នាមចិត្ត	ស・្・ន・ា・ម・ច・ិ・ត・្・ត
ស្នឹមចិត្ត	ស・្・ន・ឹ・ម・ច・ិ・ត・្・ត
ស្ម័គ្រចិត្ត	ស・្・ម・័・គ・្・រ・ច・ិ・ត・្・ត
ទាហានស្ម័គ្រចិត្ត	ទ・ា・ហ・ា・ន・ស・្・ម・័・គ・្・រ・ច・ិ・ត・្・ត
ស្រណុកចិត្ត	ស・្・រ・ណ・ុ・ក・ច・ិ・ត・្・ត
ស្រពន់ចិត្ត	ស・្・រ・ព・ន・់・ច・ិ・ត・្・ត
ស្រមុតចិត្ត	ស・្・រ・ម・ុ・ត・ច・ិ・ត・្・ត
ស្រយង់ចិត្ត	ស・្・រ・យ・ង・់・ច・ិ・ត・្・ត
ស្រវឹងចិត្ត	ស・្・រ・វ・ឹ・ង・ច・ិ・ត・្・ត
ស្រវឹងសម្បត្តិ	ស・្・រ・វ・ឹ・ង・ស・ម・្・ប・ត・្・ត・ិ
ស្លាប់ចិត្ត	ស・្・ល・ា・ប・់・ច・ិ・ត・្・ត
ស្វ័យប្រវត្ត	ស・្・វ・័・យ・ប・្・រ・វ・ត・្・ត
ស្វ័យប្រវត្តិ	ស・្・វ・័・យ・ប・្・រ・វ・ត・្・ត・ិ
ស្វ័យប្រវត្តិកម្ម	ស・្・វ・័・យ・ប・្・រ・វ・ត・្・ត・ិ・ក・ម・្・ម
ស្អាងចិត្តជាថ្មី	ស・្・អ・ា・ង・ច・ិ・ត・្・ត・ជ・ា・ថ・្・ម・ី
ហដ្ឋចិត្ត	ហ・ដ・្・ឋ・ច・ិ・ត・្・ត
ហយោត្តម	ហ・យ・ោ・ត・្・ត・ម
ហសិតុប្បាទចិត្ត	ហ・ស・ិ・ត・ុ・ប・្・ប・ា・ទ・ច・ិ・ត・្・ត
ហាសចិត្ត	ហ・ា・ស・ច・ិ・ត・្・ត
ហិរិឱត្តប្បៈ	ហ・ិ・រ・ិ・ឱ・ត・្・ត・ប・្・ប・ៈ
ហិរោត្តប្បៈ	ហ・ិ・រ・ោ・ត・្・ត・ប・្・ប・ៈ
ហួសចិត្ត	ហ・ួ・ស・ច・ិ・ត・្・ត
ចិត្តហេងហាង	ច・ិ・ត・្・ត・ហ・េ・ង・ហ・ា・ង
ឡើងចិត្ត	ឡ・ើ・ង・ច・ិ・ត・្・ត
ឡើងចិត្តឡើងចាង	ឡ・ើ・ង・ច・ិ・ត・្・ត・ឡ・ើ・ង・ច・ា・ង
ឡើងទឹកចិត្ត	ឡ・ើ・ង・ទ・ឹ・ក・ច・ិ・ត・្・ត
អកុសលចិត្ត	អ・ក・ុ・ស・ល・ច・ិ・ត・្・ត
អក្ខធុត្តី	អ・ក・្・ខ・ធ・ុ・ត・្・ត・ី
អក្ខរសម្បត្តិ	អ・ក・្・ខ・រ・ស・ម・្・ប・ត・្・ត・ិ
អក្ខរវិបត្តិ	អ・ក・្・ខ・រ・វ・ិ・ប・ត・្・ត・ិ
អគាធចិត្ត	អ・គ・ា・ធ・ច・ិ・ត・្・ត
អង្កុញចិត្ត	អ・ង・្・ក・ុ・ញ・ច・ិ・ត・្・ត
អង្គបញ្ញត្តិ	អ・ង・្・គ・ប・ញ・្・ញ・ត・្・ត・ិ
អង្គនីតិបញ្ញត្តិ	អ・ង・្・គ・ន・ី・ត・ិ・ប・ញ・្・ញ・ត・្・ត・ិ
អង្គនីតិប្រតិបត្តិ	អ・ង・្・គ・ន・ី・ត・ិ・ប・្・រ・ត・ិ・ប・ត・្・ត・ិ
អង្គរវត្ត	អ・ង・្・គ・រ・វ・ត・្・ត
អង្វរចិត្ត	អ・ង・្・វ・រ・ច・ិ・ត・្・ត
អចលចិត្ត	អ・ច・ល・ច・ិ・ត・្・ត
អចិត្ត	អ・ច・ិ・ត・្・ត
អចិត្ត!	អ・ច・ិ・ត・្・ត・!
អចិត្តជន	អ・ច・ិ・ត・្・ត・ជ・ន
អចិត្តបុគ្គល	អ・ច・ិ・ត・្・ត・ប・ុ・គ・្・គ・ល
អចិត្តក—	អ・ច・ិ・ត・្・ត・ក・—
អចិត្តកៈ	អ・ច・ិ・ត・្・ត・ក・ៈ
អចិត្តកកម្ម	អ・ច・ិ・ត・្・ត・ក・ក・ម・្・ម
អចិត្តកទោស	អ・ច・ិ・ត・្・ត・ក・ទ・ោ・ស
អចិត្តកាបត្តិ	អ・ច・ិ・ត・្・ត・ក・ា・ប・ត・្・ត・ិ
អចិត្តកាបត្តិ	អ・ច・ិ・ត・្・ត・ក・ា・ប・ត・្・ត・ិ
អចិត្តា	អ・ច・ិ・ត・្・ត・ា
អចិត្តិភាព	អ・ច・ិ・ត・្・ត・ិ・ភ・ា・ព
អច្ឆិទ្ទវុត្តិនី	អ・ច・្・ឆ・ិ・ទ・្・ទ・វ・ុ・ត・្・ត・ិ・ន・ី
អច្ឆិទ្ទវុត្តី	អ・ច・្・ឆ・ិ・ទ・្・ទ・វ・ុ・ត・្・ត・ី
អច្ឆិទ្រព្រឹត្តិ	អ・ច・្・ឆ・ិ・ទ・្・រ・ព・្・រ・ឹ・ត・្・ត・ិ
អជ្ឈត្តសន្តាន	អ・ជ・្・ឈ・ត・្・ត・ស・ន・្・ត・ា・ន
អជ្ឈត្តិកទាន	អ・ជ・្・ឈ・ត・្・ត・ិ・ក・ទ・ា・ន
អជ្ឈុបាតកសត្ត	អ・ជ・្・ឈ・ុ・ប・ា・ត・ក・ស・ត・្・ត
អជ្ឈុប្បាតកសត្ត	អ・ជ・្・ឈ・ុ・ប・្・ប・ា・ត・ក・ស・ត・្・ត
អញ្ញបដិបត្តិ	អ・ញ・្・ញ・ប・ដ・ិ・ប・ត・្・ត・ិ
អញ្ញប្បដិបត្តិ	អ・ញ・្・ញ・ប・្・ប・ដ・ិ・ប・ត・្・ត・ិ
អដ្ឋិចម្មសត្ត	អ・ដ・្・ឋ・ិ・ច・ម・្・ម・ស・ត・្・ត
អឌ្ឍរត្តិ	អ・ឌ・្・ឍ・រ・ត・្・ត・ិ
អឌ្ឍសត្តាហៈ	អ・ឌ・្・ឍ・ស・ត・្・ត・ា・ហ・ៈ
អណ្ដែតចិត្ត	អ・ណ・្・ដ・ែ・ត・ច・ិ・ត・្・ត
អតិជាតបុត្ត	អ・ត・ិ・ជ・ា・ត・ប・ុ・ត・្・ត
អតិថិវត្ត	អ・ត・ិ・ថ・ិ・វ・ត・្・ត
អតិរេកភត្ត	អ・ត・ិ・រ・េ・ក・ភ・ត・្・ត
អតេកិច្ឆាបត្តិ	អ・ត・េ・ក・ិ・ច・្・ឆ・ា・ប・ត・្・ត・ិ
អតេតិច្ឆាបត្តិ	អ・ត・េ・ត・ិ・ច・្・ឆ・ា・ប・ត・្・ត・ិ
អត្ត	អ・ត・្・ត
អត្តកិច្ច	អ・ត・្・ត・ក・ិ・ច・្・ច
អត្តកិលមថានុយោគ	អ・ត・្・ត・ក・ិ・ល・ម・ថ・ា・ន・ុ・យ・ោ・គ
អត្តឃាត	អ・ត・្・ត・ឃ・ា・ត
អត្តឃាតកម្ម	អ・ត・្・ត・ឃ・ា・ត・ក・ម・្・ម
អត្តទត្ថ	អ・ត・្・ត・ទ・ត・្・ថ
អត្តទត្ថបុគ្គល	អ・ត・្・ត・ទ・ត・្・ថ・ប・ុ・គ・្・គ・ល
អត្តទត្ថភាព	អ・ត・្・ត・ទ・ត・្・ថ・ភ・ា・ព
អត្តទន្ត	អ・ត・្・ត・ទ・ន・្・ត
អត្តទន្តី	អ・ត・្・ត・ទ・ន・្・ត・ី
អត្តបរិហារ	អ・ត・្・ត・ប・រ・ិ・ហ・ា・រ
អត្តព្យាបាល	អ・ត・្・ត・ព・្・យ・ា・ប・ា・ល
អត្តភាព	អ・ត・្・ត・ភ・ា・ព
អត្តលេខ	អ・ត・្・ត・ល・េ・ខ
អត្តវិនិបាតកម្ម	អ・ត・្・ត・វ・ិ・ន・ិ・ប・ា・ត・ក・ម・្・ម
អត្តសន្និយាតន៍	អ・ត・្・ត・ស・ន・្・ន・ិ・យ・ា・ត・ន・៍
អត្តសម្មាបណិធិ	អ・ត・្・ត・ស・ម・្・ម・ា・ប・ណ・ិ・ធ・ិ
អត្តហេតុ	អ・ត・្・ត・ហ・េ・ត・ុ
អត្តានុវាទភ័យ	អ・ត・្・ត・ា・ន・ុ・វ・ា・ទ・ភ・័・យ
អត្តាភិបាល	អ・ត・្・ត・ា・ភ・ិ・ប・ា・ល
អត្ត—	អ・ត・្・ត・—
អត្តៈ	អ・ត・្・ត・ៈ
អត្តកិលមកម្ម	អ・ត・្・ត・ក・ិ・ល・ម・ក・ម・្・ម
អត្តខាត់	អ・ត・្・ត・ខ・ា・ត・់
អត្តទត្ថនិយម	អ・ត・្・ត・ទ・ត・្・ថ・ន・ិ・យ・ម
អត្តនោបទ	អ・ត・្・ត・ន・ោ・ប・ទ
អត្តនោបទ	អ・ត・្・ត・ន・ោ・ប・ទ
អត្តនោមតិភាព	អ・ត・្・ត・ន・ោ・ម・ត・ិ・ភ・ា・ព
អត្តនោមត្យាធិប្បាយ	អ・ត・្・ត・ន・ោ・ម・ត・្・យ・ា・ធ・ិ・ប・្・ប・ា・យ
អត្តនោម័តិ	អ・ត・្・ត・ន・ោ・ម・័・ត・ិ
អត្តពលកម្ម	អ・ត・្・ត・ព・ល・ក・ម・្・ម
អត្តពលិក	អ・ត・្・ត・ព・ល・ិ・ក
អត្តពលិកា	អ・ត・្・ត・ព・ល・ិ・ក・ា
អត្តពិគ្រោះ	អ・ត・្・ត・ព・ិ・គ・្・រ・ោ・ះ
អត្តសញ្ញាណ	អ・ត・្・ត・ស・ញ・្・ញ・ា・ណ
អត្តសញ្ញាណជាតិ	អ・ត・្・ត・ស・ញ・្・ញ・ា・ណ・ជ・ា・ត・ិ
អត្តសញ្ញាណបត្រ	អ・ត・្・ត・ស・ញ・្・ញ・ា・ណ・ប・ត・្・រ
អត្តសញ្ញាណប័ណ្ណ	អ・ត・្・ត・ស・ញ・្・ញ・ា・ណ・ប・័・ណ・្・ណ
អត្តា	អ・ត・្・ត・ា
អត្តា—	អ・ត・្・ត・ា・—
អត្តាធិបតី	អ・ត・្・ត・ា・ធ・ិ・ប・ត・ី
អត្តាធិបតេយ្យ	អ・ត・្・ត・ា・ធ・ិ・ប・ត・េ・យ・្・យ
អត្តាធីនភាព	អ・ត・្・ត・ា・ធ・ី・ន・ភ・ា・ព
អត្តាពិគ្រោះ	អ・ត・្・ត・ា・ព・ិ・គ・្・រ・ោ・ះ
អត្តាវសនិយម	អ・ត・្・ត・ា・វ・ស・ន・ិ・យ・ម
អត្តាវសាធិបតេយ្យ	អ・ត・្・ត・ា・វ・ស・ា・ធ・ិ・ប・ត・េ・យ・្・យ
អត្តាវសិក	អ・ត・្・ត・ា・វ・ស・ិ・ក
អត្តាវសី	អ・ត・្・ត・ា・វ・ស・ី
អត្តុ—	អ・ត・្・ត・ុ・—
អត្តុក្កង្សនកថា	អ・ត・្・ត・ុ・ក・្・ក・ង・្・ស・ន・ក・ថ・ា
អត្តុក្កង្សនភាព	អ・ត・្・ត・ុ・ក・្・ក・ង・្・ស・ន・ភ・ា・ព
អត្តូបជីវ	អ・ត・្・ត・ូ・ប・ជ・ី・វ
អត្តូបជីវិនី	អ・ត・្・ត・ូ・ប・ជ・ី・វ・ិ・ន・ី
អត្តូបជីវី	អ・ត・្・ត・ូ・ប・ជ・ី・វ・ី
អត្តប្រយោគ	អ・ត・្・ត・ប・្・រ・យ・ោ・គ
អត្ថវិបត្តិ	អ・ត・្・ថ・វ・ិ・ប・ត・្・ត・ិ
អទត្តពល	អ・ទ・ត・្・ត・ព・ល
អទិដ្ឋមិត្ត	អ・ទ・ិ・ដ・្・ឋ・ម・ិ・ត・្・ត
អធិចិត្ត	អ・ធ・ិ・ច・ិ・ត・្・ត
អធិចិត្តសិក្ខា	អ・ធ・ិ・ច・ិ・ត・្・ត・ស・ិ・ក・្・ខ・ា
អធិមត្ត	អ・ធ・ិ・ម・ត・្・ត
អធិមុត្តិ	អ・ធ・ិ・ម・ុ・ត・្・ត・ិ
អធិមុត្តិភាព	អ・ធ・ិ・ម・ុ・ត・្・ត・ិ・ភ・ា・ព
អធិមុត្តិនិយម	អ・ធ・ិ・ម・ុ・ត・្・ត・ិ・ន・ិ・យ・ម
បុត្តាធីន	ប・ុ・ត・្・ត・ា・ធ・ី・ន
អត្តាធីន	អ・ត・្・ត・ា・ធ・ី・ន
អធ្យុត្តម	អ・ធ・្・យ・ុ・ត・្・ត・ម
អន់ចិត្ត	អ・ន・់・ច・ិ・ត・្・ត
អនត្តលក្ខណ	អ・ន・ត・្・ត・ល・ក・្・ខ・ណ
អនត្តលក្ខណៈ	អ・ន・ត・្・ត・ល・ក・្・ខ・ណ・ៈ
អនត្តសញ្ញា	អ・ន・ត・្・ត・ស・ញ・្・ញ・ា
អនត្តា	អ・ន・ត・្・ត・ា
អនត្តាធីន	អ・ន・ត・្・ត・ា・ធ・ី・ន
អនត្តានុបស្សនា	អ・ន・ត・្・ត・ា・ន・ុ・ប・ស・្・ស・ន・ា
អនត្តានុបស្សិន	អ・ន・ត・្・ត・ា・ន・ុ・ប・ស・្・ស・ិ・ន
អនត្តានុបស្សិនី	អ・ន・ត・្・ត・ា・ន・ុ・ប・ស・្・ស・ិ・ន・ី
អនត្តានុបស្សី	អ・ន・ត・្・ត・ា・ន・ុ・ប・ស・្・ស・ី
អនត្តា—	អ・ន・ត・្・ត・ា・—
អនភិសិត្តរាជ	អ・ន・ភ・ិ・ស・ិ・ត・្・ត・រ・ា・ជ
អនាទរមិត្ត	អ・ន・ា・ទ・រ・ម・ិ・ត・្・ត
អនាទរាបត្តិ	អ・ន・ា・ទ・រ・ា・ប・ត・្・ត・ិ
អានាទរាបត្តិ	អ・ា・ន・ា・ទ・រ・ា・ប・ត・្・ត・ិ
អនាបត្តិ	អ・ន・ា・ប・ត・្・ត・ិ
អនិមិត្ត	អ・ន・ិ・ម・ិ・ត・្・ត
អនិមិត្ត	អ・ន・ិ・ម・ិ・ត・្・ត
អនិមិត្តភាព	អ・ន・ិ・ម・ិ・ត・្・ត・ភ・ា・ព
អនិស្សយមុត្តក	អ・ន・ិ・ស・្・ស・យ・ម・ុ・ត・្・ត・ក
អនិស្សយមុត្តក៍	អ・ន・ិ・ស・្・ស・យ・ម・ុ・ត・្・ត・ក・៍
អនិស្សយមុត្តិកា	អ・ន・ិ・ស・្・ស・យ・ម・ុ・ត・្・ត・ិ・ក・ា
អនីតិជនអត្តាធីន	អ・ន・ី・ត・ិ・ជ・ន・អ・ត・្・ត・ា・ធ・ី・ន
អនុកម្បចិត្ត	អ・ន・ុ・ក・ម・្・ប・ច・ិ・ត・្・ត
អនុប្បញ្ញត្តិ	អ・ន・ុ・ប・្・ប・ញ・្・ញ・ត・្・ត・ិ
អនុវត្តិ	អ・ន・ុ・វ・ត・្・ត・ិ
អនុជាតបុត្ត	អ・ន・ុ・ជ・ា・ត・ប・ុ・ត・្・ត
អនុត្តរ	អ・ន・ុ・ត・្・ត・រ
អនុត្តរ	អ・ន・ុ・ត・្・ត・រ
អនុត្តរធម៌	អ・ន・ុ・ត・្・ត・រ・ធ・ម・៌
អនុត្តរសម្ពោធិញ្ញាណ	អ・ន・ុ・ត・្・ត・រ・ស・ម・្・ព・ោ・ធ・ិ・ញ・្・ញ・ា・ណ
អនុត្តរសម្មាសម្ពោធិ	អ・ន・ុ・ត・្・ត・រ・ស・ម・្・ម・ា・ស・ម・្・ព・ោ・ធ・ិ
អនុត្តរបុគ្គល	អ・ន・ុ・ត・្・ត・រ・ប・ុ・គ・្・គ・ល
អនុត្តរភាព	អ・ន・ុ・ត・្・ត・រ・ភ・ា・ព
អនុត្តរភាពនិយម	អ・ន・ុ・ត・្・ត・រ・ភ・ា・ព・ន・ិ・យ・ម
អនុវត្ត	អ・ន・ុ・វ・ត・្・ត
អនុវត្តន៍	អ・ន・ុ・វ・ត・្・ត・ន・៍
អនោតត្ត	អ・ន・ោ・ត・ត・្・ត
អនោតត្តស្រះ	អ・ន・ោ・ត・ត・្・ត・ស・្・រ・ះ
អនោមកសត្ត	អ・ន・ោ・ម・ក・ស・ត・្・ត
អនោមសត្ត	អ・ន・ោ・ម・ស・ត・្・ត
អន្តរាបត្តិ	អ・ន・្・ត・រ・ា・ប・ត・្・ត・ិ
អន្តរចិត្តវិជ្ជា	អ・ន・្・ត・រ・ច・ិ・ត・្・ត・វ・ិ・ជ・្・ជ・ា
អន្តរត្តិភាព	អ・ន・្・ត・រ・ត・្・ត・ិ・ភ・ា・ព
អន្តរប្បញ្ញត្តិ	អ・ន・្・ត・រ・ប・្・ប・ញ・្・ញ・ត・្・ត・ិ
អន្តិមត្តភាព	អ・ន・្・ត・ិ・ម・ត・្・ត・ភ・ា・ព
ចិត្តអន្យតិរ្ថិយ	ច・ិ・ត・្・ត・អ・ន・្・យ・ត・ិ・រ・្・ថ・ិ・យ
អបចិត្ត	អ・ប・ច・ិ・ត・្・ត
អបាយសត្ត	អ・ប・ា・យ・ស・ត・្・ត
អបាយសំវត្តនិក	អ・ប・ា・យ・ស・ំ・វ・ត・្・ត・ន・ិ・ក
អបុត្តក	អ・ប・ុ・ត・្・ត・ក
អបុត្តកោ	អ・ប・ុ・ត・្・ត・ក・ោ
អបុត្តកៈ	អ・ប・ុ・ត・្・ត・ក・ៈ
អបុត្តិកា	អ・ប・ុ・ត・្・ត・ិ・ក・ា
អប្បដិឃចិត្ត	អ・ប・្・ប・ដ・ិ・ឃ・ច・ិ・ត・្・ត
អប្បដិវត្ត	អ・ប・្・ប・ដ・ិ・វ・ត・្・ត
អប្បដិវត្តន៍	អ・ប・្・ប・ដ・ិ・វ・ត・្・ត・ន・៍
អប្បដិវត្តិយកម្ម	អ・ប・្・ប・ដ・ិ・វ・ត・្・ត・ិ・យ・ក・ម・្・ម
អប្បដិវត្តិយៈ	អ・ប・្・ប・ដ・ិ・វ・ត・្・ត・ិ・យ・ៈ
អប្បដិវត្តិយ៍	អ・ប・្・ប・ដ・ិ・វ・ត・្・ត・ិ・យ・៍
អប្បដិបត្តិ	អ・ប・្・ប・ដ・ិ・ប・ត・្・ត・ិ
អប្បនាចិត្ត	អ・ប・្・ប・ន・ា・ច・ិ・ត・្・ត
អប្បិយបុត្ត	អ・ប・្・ប・ិ・យ・ប・ុ・ត・្・ត
អប្បេសក្ខទេវបុត្ត	អ・ប・្・ប・េ・ស・ក・្・ខ・ទ・េ・វ・ប・ុ・ត・្・ត
អប្រតិឃចិត្ត	អ・ប・្・រ・ត・ិ・ឃ・ច・ិ・ត・្・ត
អព្ភមុត្ត	អ・ព・្・ភ・ម・ុ・ត・្・ត
អព្យត្ត	អ・ព・្・យ・ត・្・ត
អព្យត្តជន	អ・ព・្・យ・ត・្・ត・ជ・ន
អព្យត្តបុគ្គល	អ・ព・្・យ・ត・្・ត・ប・ុ・គ・្・គ・ល
អព្យត្តភាព	អ・ព・្・យ・ត・្・ត・ភ・ា・ព
អព្យត្តវោហារ	អ・ព・្・យ・ត・្・ត・វ・ោ・ហ・ា・រ
អព្យត្ត—	អ・ព・្・យ・ត・្・ត・—
អព្យត្តា	អ・ព・្・យ・ត・្・ត・ា
អព្យ័ត្ត	អ・ព・្・យ・័・ត・្・ត
អព្យាកតចិត្ត	អ・ព・្・យ・ា・ក・ត・ច・ិ・ត・្・ត
អភិគោត្ត	អ・ភ・ិ・គ・ោ・ត・្・ត
ខេត្តាភិបាល	ខ・េ・ត・្・ត・ា・ភ・ិ・ប・ា・ល
អភិបាលខេត្ត	អ・ភ・ិ・ប・ា・ល・ខ・េ・ត・្・ត
អភិសមាចារិកវត្ត	អ・ភ・ិ・ស・ម・ា・ច・ា・រ・ិ・ក・វ・ត・្・ត
អភិសិត្តរាជ	អ・ភ・ិ・ស・ិ・ត・្・ត・រ・ា・ជ
អមត្តញ្ញុតា	អ・ម・ត・្・ត・ញ・្・ញ・ុ・ត・ា
អមត្តញ្ញូ	អ・ម・ត・្・ត・ញ・្・ញ・ូ
អមិត្ត	អ・ម・ិ・ត・្・ត
អមិត្តភាព	អ・ម・ិ・ត・្・ត・ភ・ា・ព
អមិត្តតាបនា	អ・ម・ិ・ត・្・ត・ត・ា・ប・ន・ា
អមោឃប្រតិបត្តិ	អ・ម・ោ・ឃ・ប・្・រ・ត・ិ・ប・ត・្・ត・ិ
ពិសាក្រៃណានឹងឃ្លាន អាក្រក់អម្បាលម៉ានក្រៃណានឹងគាប់ចិត្ត	ព・ិ・ស・ា・ក・្・រ・ៃ・ណ・ា・ន・ឹ・ង・ឃ・្・ល・ា・ន・ ・អ・ា・ក・្・រ・ក・់・អ・ម・្・ប・ា・ល・ម・៉・ា・ន・ក・្・រ・ៃ・ណ・ា・ន・ឹ・ង・គ・ា・ប・់・ច・ិ・ត・្・ត
អយុត្ត	អ・យ・ុ・ត・្・ត
អយុត្តកម្ម	អ・យ・ុ・ត・្・ត・ក・ម・្・ម
អយុត្តកិច្ច	អ・យ・ុ・ត・្・ត・ក・ិ・ច・្・ច
អយុត្តធម៌	អ・យ・ុ・ត・្・ត・ធ・ម・៌
អយុត្តភាព	អ・យ・ុ・ត・្・ត・ភ・ា・ព
អយុត្តរូប	អ・យ・ុ・ត・្・ត・រ・ូ・ប
អយុត្តវាចា	អ・យ・ុ・ត・្・ត・វ・ា・ច・ា
អយុត្តវាទ	អ・យ・ុ・ត・្・ត・វ・ា・ទ
អយុត្តវាទិនី	អ・យ・ុ・ត・្・ត・វ・ា・ទ・ិ・ន・ី
អយុត្តវាទី	អ・យ・ុ・ត・្・ត・វ・ា・ទ・ី
អយុត្តសន្និដ្ឋាន	អ・យ・ុ・ត・្・ត・ស・ន・្・ន・ិ・ដ・្・ឋ・ា・ន
អយុត្ត—	អ・យ・ុ・ត・្・ត・—
អយុត្តិធម៌	អ・យ・ុ・ត・្・ត・ិ・ធ・ម・៌
អយ្យបុត្ត	អ・យ・្・យ・ប・ុ・ត・្・ត
អរហត្ត	អ・រ・ហ・ត・្・ត
អរហត្តផ	អ・រ・ហ・ត・្・ត・ផ
អរហត្តផល	អ・រ・ហ・ត・្・ត・ផ・ល
អរហត្តមគ្គ	អ・រ・ហ・ត・្・ត・ម・គ・្・គ
យកអរុណក្នុងវត្ត	យ・ក・អ・រ・ុ・ណ・ក・្・ន・ុ・ង・វ・ត・្・ត
អលោភចិត្ត	អ・ល・ោ・ភ・ច・ិ・ត・្・ត
អវជាតបុត្ត	អ・វ・ជ・ា・ត・ប・ុ・ត・្・ត
អវត្តមាន	អ・វ・ត・្・ត・ម・ា・ន
អវត្តមាន	អ・វ・ត・្・ត・ម・ា・ន
អវសានប្បញ្ញត្តិ	អ・វ・ស・ា・ន・ប・្・ប・ញ・្・ញ・ត・្・ត・ិ
អស់ចិត្ត	អ・ស・់・ច・ិ・ត・្・ត
អសញ្ញីសត្ត	អ・ស・ញ・្・ញ・ី・ស・ត・្・ត
អសាធារណប្បញ្ញត្តិ	អ・ស・ា・ធ・ា・រ・ណ・ប・្・ប・ញ・្・ញ・ត・្・ត・ិ
អសុទ្ធចិត្ត	អ・ស・ុ・ទ・្・ធ・ច・ិ・ត・្・ត
អស្សុជលនេត្ត	អ・ស・្・ស・ុ・ជ・ល・ន・េ・ត・្・ត
អហេតុកចិត្ត	អ・ហ・េ・ត・ុ・ក・ច・ិ・ត・្・ត
អហេតុកសត្ត	អ・ហ・េ・ត・ុ・ក・ស・ត・្・ត
អហោរត្ត	អ・ហ・ោ・រ・ត・្・ត
អាក់អន់ស្រពន់ចិត្ត	អ・ា・ក・់・អ・ន・់・ស・្・រ・ព・ន・់・ច・ិ・ត・្・ត
អាកុលចិត្ត	អ・ា・ក・ុ・ល・ច・ិ・ត・្・ត
អាក្រោធចិត្ត	អ・ា・ក・្・រ・ោ・ធ・ច・ិ・ត・្・ត
អាគន្តុកភត្ត	អ・ា・គ・ន・្・ត・ុ・ក・ភ・ត・្・ត
អាគន្តុកវត្ត	អ・ា・គ・ន・្・ត・ុ・ក・វ・ត・្・ត
អាឃាតវិមុត្ត	អ・ា・ឃ・ា・ត・វ・ិ・ម・ុ・ត・្・ត
អាចរិយមត្ត	អ・ា・ច・រ・ិ・យ・ម・ត・្・ត
អាចរិយវត្ត	អ・ា・ច・រ・ិ・យ・វ・ត・្・ត
អាចារវិបត្តិ	អ・ា・ច・ា・រ・វ・ិ・ប・ត・្・ត・ិ
អាចារសម្បត្តិ	អ・ា・ច・ា・រ・ស・ម・្・ប・ត・្・ត・ិ
អាចារ្យសម្រាប់វត្ត	អ・ា・ច・ា・រ・្・យ・ស・ម・្・រ・ា・ប・់・វ・ត・្・ត
អាចារ្យវត្ត	អ・ា・ច・ា・រ・្・យ・វ・ត・្・ត
អាចិណ្ណវត្ត	អ・ា・ច・ិ・ណ・្・ណ・វ・ត・្・ត
អាចិណ្ណសម្បត្តិ	អ・ា・ច・ិ・ណ・្・ណ・ស・ម・្・ប・ត・្・ត・ិ
អាជីវប្បវុត្តិ	អ・ា・ជ・ី・វ・ប・្・ប・វ・ុ・ត・្・ត・ិ
អាជីវប្រព្រឹត្តិ	អ・ា・ជ・ី・វ・ប・្・រ・ព・្・រ・ឹ・ត・្・ត・ិ
អាណត្តិ	អ・ា・ណ・ត・្・ត・ិ
អាណត្តិកម្ម	អ・ា・ណ・ត・្・ត・ិ・ក・ម・្・ម
អាណត្តិការណ៍	អ・ា・ណ・ត・្・ត・ិ・ក・ា・រ・ណ・៍
អាណត្តិកិរិយា	អ・ា・ណ・ត・្・ត・ិ・ក・ិ・រ・ិ・យ・ា
អាណត្តិពាក្យ	អ・ា・ណ・ត・្・ត・ិ・ព・ា・ក・្・យ
អាណត្តិភាព	អ・ា・ណ・ត・្・ត・ិ・ភ・ា・ព
អាណត្តិលក្ខណៈ	អ・ា・ណ・ត・្・ត・ិ・ល・ក・្・ខ・ណ・ៈ
អាណត្តិលក្ខណ៍	អ・ា・ណ・ត・្・ត・ិ・ល・ក・្・ខ・ណ・៍
អាណត្តិវាក្យ	អ・ា・ណ・ត・្・ត・ិ・វ・ា・ក・្・យ
អាណត្តិវាចា	អ・ា・ណ・ត・្・ត・ិ・វ・ា・ច・ា
អាណត្តិវាទ	អ・ា・ណ・ត・្・ត・ិ・វ・ា・ទ
អាណត្តិសញ្ញា	អ・ា・ណ・ត・្・ត・ិ・ស・ញ・្・ញ・ា
អាណត្តិសព្ទ	អ・ា・ណ・ត・្・ត・ិ・ស・ព・្・ទ
អាណត្តិ	អ・ា・ណ・ត・្・ត・ិ
អាណត្តិ	អ・ា・ណ・ត・្・ត・ិ
អាណត្តិ	អ・ា・ណ・ត・្・ត・ិ
អាណត្តិ—	អ・ា・ណ・ត・្・ត・ិ・—
អាណត្តិទូរលិក	អ・ា・ណ・ត・្・ត・ិ・ទ・ូ・រ・ល・ិ・ក
អាណាបវត្តិ	អ・ា・ណ・ា・ប・វ・ត・្・ត・ិ
អាណាខេត្ត	អ・ា・ណ・ា・ខ・េ・ត・្・ត
អាទរប្រតិបត្តិ	អ・ា・ទ・រ・ប・្・រ・ត・ិ・ប・ត・្・ត・ិ
អាទរមិត្ត	អ・ា・ទ・រ・ម・ិ・ត・្・ត
អាទិច្ចគោត្ត	អ・ា・ទ・ិ・ច・្・ច・គ・ោ・ត・្・ត
បត្តាធារ	ប・ត・្・ត・ា・ធ・ា・រ
អាបត្តិ	អ・ា・ប・ត・្・ត・ិ
ភិក្ខុសម្ដែងអាបត្តិ	ភ・ិ・ក・្・ខ・ុ・ស・ម・្・ដ・ែ・ង・អ・ា・ប・ត・្・ត・ិ
អាបាយិកសត្ត	អ・ា・ប・ា・យ・ិ・ក・ស・ត・្・ត
អាភោគចិត្ត	អ・ា・ភ・ោ・គ・ច・ិ・ត・្・ត
អាមកភត្ត	អ・ា・ម・ក・ភ・ត・្・ត
មុត្តាយតនៈ	ម・ុ・ត・្・ត・ា・យ・ត・ន・ៈ
អាយុត្តកដ្ឋាន	អ・ា・យ・ុ・ត・្・ត・ក・ដ・្・ឋ・ា・ន
អាយុត្តកៈ	អ・ា・យ・ុ・ត・្・ត・ក・ៈ
អារម្ភចិត្ត	អ・ា・រ・ម・្・ភ・ច・ិ・ត・្・ត
អាវាសិកវត្ត	អ・ា・វ・ា・ស・ិ・ក・វ・ត・្・ត
ឥតិវុត្តក	ឥ・ត・ិ・វ・ុ・ត・្・ត・ក
ឥត្ថីកុត្ត	ឥ・ត・្・ថ・ី・ក・ុ・ត・្・ត
ឥត្ថីធុត្តភាព	ឥ・ត・្・ថ・ី・ធ・ុ・ត・្・ត・ភ・ា・ព
ឥត្ថីធុត្តៈ	ឥ・ត・្・ថ・ី・ធ・ុ・ត・្・ត・ៈ
ឥត្ថុម្មត្តកៈ	ឥ・ត・្・ថ・ុ・ម・្・ម・ត・្・ត・ក・ៈ
ឥធលោកត្តភាព	ឥ・ធ・ល・ោ・ក・ត・្・ត・ភ・ា・ព
ឥន្ទបត្ត	ឥ・ន・្・ទ・ប・ត・្・ត
ឥរិយាបថបរិវត្តន៍	ឥ・រ・ិ・យ・ា・ប・ថ・ប・រ・ិ・វ・ត・្・ត・ន・៍
ឥរិយាបថសម្បត្តិ	ឥ・រ・ិ・យ・ា・ប・ថ・ស・ម・្・ប・ត・្・ត・ិ
ឥស្សរចិត្ត	ឥ・ស・្・ស・រ・ច・ិ・ត・្・ត
ឧក្កដ្ឋប្បញ្ញត្តិ	ឧ・ក・្・ក・ដ・្・ឋ・ប・្・ប・ញ・្・ញ・ត・្・ត・ិ
ឧក្កដ្ឋប្បដិបត្តិ	ឧ・ក・្・ក・ដ・្・ឋ・ប・្・ប・ដ・ិ・ប・ត・្・ត・ិ
ឧគ្គហនិមិត្ត	ឧ・គ・្・គ・ហ・ន・ិ・ម・ិ・ត・្・ត
ឧច្ចគោត្ត	ឧ・ច・្・ច・គ・ោ・ត・្・ត
ឧច្ឆត្ត	ឧ・ច・្・ឆ・ត・្・ត
ឧច្ឆត្ត	ឧ・ច・្・ឆ・ត・្・ត
ឧច្ឆត្តកូល	ឧ・ច・្・ឆ・ត・្・ត・ក・ូ・ល
ឧច្ឆត្តកូល	ឧ・ច・្・ឆ・ត・្・ត・ក・ូ・ល
ឧច្ឆត្តជាតិ	ឧ・ច・្・ឆ・ត・្・ត・ជ・ា・ត・ិ
ឧច្ឆត្តបុស្ប	ឧ・ច・្・ឆ・ត・្・ត・ប・ុ・ស・្・ប
ឧជុចិត្ត	ឧ・ជ・ុ・ច・ិ・ត・្・ត
ឧជុប្បដិបត្តិ	ឧ・ជ・ុ・ប・្・ប・ដ・ិ・ប・ត・្・ត・ិ
ឧជុបត្តសត្វ	ឧ・ជ・ុ・ប・ត・្・ត・ស・ត・្・វ
ឧដុង្គឧត្តម	ឧ・ដ・ុ・ង・្・គ・ឧ・ត・្・ត・ម
ឧណ្ហចិត្ត	ឧ・ណ・្・ហ・ច・ិ・ត・្・ត
ឧណ្ហ៍ចិត្ត	ឧ・ណ・្・ហ・៍・ច・ិ・ត・្・ត
ឧត្តមបុរស	ឧ・ត・្・ត・ម・ប・ុ・រ・ស
ឧត្តម	ឧ・ត・្・ត・ម
ថ្នាក់ឧត្តម	ថ・្・ន・ា・ក・់・ឧ・ត・្・ត・ម
ប្រសើរឧត្តម	ប・្・រ・ស・ើ・រ・ឧ・ត・្・ត・ម
ផលស្រូវឧត្តម	ផ・ល・ស・្・រ・ូ・វ・ឧ・ត・្・ត・ម
ពង្សពូជឧត្តម	ព・ង・្・ស・ព・ូ・ជ・ឧ・ត・្・ត・ម
ពូជពង្សឧត្តម	ព・ូ・ជ・ព・ង・្・ស・ឧ・ត・្・ត・ម
ឧត្តមគន្ធ	ឧ・ត・្・ត・ម・គ・ន・្・ធ
ឧត្តមគោត្ត	ឧ・ត・្・ត・ម・គ・ោ・ត・្・ត
ឧត្តមគោត្ត	ឧ・ត・្・ត・ម・គ・ោ・ត・្・ត
ឧត្តមគោត្រ	ឧ・ត・្・ត・ម・គ・ោ・ត・្・រ
ឧត្តមគ្រឹហា	ឧ・ត・្・ត・ម・គ・្・រ・ឹ・ហ・ា
ឧត្តមគ្រឹះ	ឧ・ត・្・ត・ម・គ・្・រ・ឹ・ះ
ឧត្តមង្គ	ឧ・ត・្・ត・ម・ង・្・គ
ឧត្តមជាតិ	ឧ・ត・្・ត・ម・ជ・ា・ត・ិ
ឧត្តមបុរិសៈ	ឧ・ត・្・ត・ម・ប・ុ・រ・ិ・ស・ៈ
ឧត្តមពង្ស	ឧ・ត・្・ត・ម・ព・ង・្・ស
ឧត្តមភូមិ	ឧ・ត・្・ត・ម・ភ・ូ・ម・ិ
ឧត្តមវង្ស	ឧ・ត・្・ត・ម・វ・ង・្・ស
ឧត្តមវិជ្ជា	ឧ・ត・្・ត・ម・វ・ិ・ជ・្・ជ・ា
ឧត្តមវិទ្យា	ឧ・ត・្・ត・ម・វ・ិ・ទ・្・យ・ា
ឧត្តមសេនានី	ឧ・ត・្・ត・ម・ស・េ・ន・ា・ន・ី
ឧត្តមស័ក្ដិ	ឧ・ត・្・ត・ម・ស・័・ក・្・ដ・ិ
ឧត្តមាង្គ	ឧ・ត・្・ត・ម・ា・ង・្・គ
ឧត្តមាភិសេក	ឧ・ត・្・ត・ម・ា・ភ・ិ・ស・េ・ក
ឧត្តម—	ឧ・ត・្・ត・ម・—
ឧត្តមៈ	ឧ・ត・្・ត・ម・ៈ
ឧត្តមគតិ	ឧ・ត・្・ត・ម・គ・ត・ិ
ឧត្តមគតិរឿង	ឧ・ត・្・ត・ម・គ・ត・ិ・រ・ឿ・ង
ឧត្តមដ្ឋាន	ឧ・ត・្・ត・ម・ដ・្・ឋ・ា・ន
ឧត្តមនាវី	ឧ・ត・្・ត・ម・ន・ា・វ・ី
ឧត្តមនាវីត្រី	ឧ・ត・្・ត・ម・ន・ា・វ・ី・ត・្・រ・ី
ឧត្តមនាវីទោ	ឧ・ត・្・ត・ម・ន・ា・វ・ី・ទ・ោ
ឧត្តមនាវីឯក	ឧ・ត・្・ត・ម・ន・ា・វ・ី・ឯ・ក
ឧត្តមប្រយោជន៍	ឧ・ត・្・ត・ម・ប・្・រ・យ・ោ・ជ・ន・៍
ឧត្តមភាព	ឧ・ត・្・ត・ម・ភ・ា・ព
ឧត្តមភេទ	ឧ・ត・្・ត・ម・ភ・េ・ទ
ឧត្តមមន្ត្រី	ឧ・ត・្・ត・ម・ម・ន・្・ត・្・រ・ី
ឧត្តមសិក្សា	ឧ・ត・្・ត・ម・ស・ិ・ក・្・ស・ា
ឧត្តមសេនីយ៍	ឧ・ត・្・ត・ម・ស・េ・ន・ី・យ・៍
ឧត្តមសេនីយ៍ត្រី	ឧ・ត・្・ត・ម・ស・េ・ន・ី・យ・៍・ត・្・រ・ី
ឧត្តមសេនីយ៍ទោ	ឧ・ត・្・ត・ម・ស・េ・ន・ី・យ・៍・ទ・ោ
ឧត្តមសេនីយ៍ឯក	ឧ・ត・្・ត・ម・ស・េ・ន・ី・យ・៍・ឯ・ក
ឧត្តមស្នងការ	ឧ・ត・្・ត・ម・ស・្・ន・ង・ក・ា・រ
ឧត្តមា	ឧ・ត・្・ត・ម・ា
ឧត្តមានុភាព	ឧ・ត・្・ត・ម・ា・ន・ុ・ភ・ា・ព
ឧត្តមានុវត្ត	ឧ・ត・្・ត・ម・ា・ន・ុ・វ・ត・្・ត
ឧត្តមានុវត្ត	ឧ・ត・្・ត・ម・ា・ន・ុ・វ・ត・្・ត
ឧត្តមោ	ឧ・ត・្・ត・ម・ោ
ឧត្តមំ	ឧ・ត・្・ត・ម・ំ
ឧត្តរ	ឧ・ត・្・ត・រ
ឧត្តរករោទ្វីប	ឧ・ត・្・ត・រ・ក・រ・ោ・ទ・្・វ・ី・ប
ឧត្តរកាយ	ឧ・ត・្・ត・រ・ក・ា・យ
ឧត្តរកាល	ឧ・ត・្・ត・រ・ក・ា・ល
ឧត្តរកុរុ	ឧ・ត・្・ត・រ・ក・ុ・រ・ុ
ឧត្តរកុរុទ្វីប	ឧ・ត・្・ត・រ・ក・ុ・រ・ុ・ទ・្・វ・ី・ប
ឧត្តរទិសាភាគ	ឧ・ត・្・ត・រ・ទ・ិ・ស・ា・ភ・ា・គ
ឧត្តរនិកាយ	ឧ・ត・្・ត・រ・ន・ិ・ក・ា・យ
ឧត្តរប័ដ	ឧ・ត・្・ត・រ・ប・័・ដ
ឧត្តរលុប	ឧ・ត・្・ត・រ・ល・ុ・ប
ឧត្តរលោប	ឧ・ត・្・ត・រ・ល・ោ・ប
ឧត្តរាព័ត៌	ឧ・ត・្・ត・រ・ា・ព・័・ត・៌
ឧត្តរាភិមុខ	ឧ・ត・្・ត・រ・ា・ភ・ិ・ម・ុ・ខ
ឧត្តរាវដ្ដ	ឧ・ត・្・ត・រ・ា・វ・ដ・្・ដ
ឧត្តរាសង្គ	ឧ・ត・្・ត・រ・ា・ស・ង・្・គ
ឧត្តរាសាឍ	ឧ・ត・្・ត・រ・ា・ស・ា・ឍ
ឧត្តរ—	ឧ・ត・្・ត・រ・—
ឧត្តរៈ	ឧ・ត・្・ត・រ・ៈ
ឧត្តរជីវី	ឧ・ត・្・ត・រ・ជ・ី・វ・ី
ឧត្តរទិស	ឧ・ត・្・ត・រ・ទ・ិ・ស
ឧត្តរមានជ័យ	ឧ・ត・្・ត・រ・ម・ា・ន・ជ・័・យ
ឧត្តរា	ឧ・ត・្・ត・រ・ា
ឧត្តរានុទិស	ឧ・ត・្・ត・រ・ា・ន・ុ・ទ・ិ・ស
ឧត្តរិ	ឧ・ត・្・ត・រ・ិ
មនុស្សឧត្តរិ	ម・ន・ុ・ស・្・ស・ឧ・ត・្・ត・រ・ិ
ឧត្តរិគមនាគម	ឧ・ត・្・ត・រ・ិ・គ・ម・ន・ា・គ・ម
ឧត្តរិត្រីមាស	ឧ・ត・្・ត・រ・ិ・ត・្・រ・ី・ម・ា・ស
ឧត្តរិទ្វិរត្ត	ឧ・ត・្・ត・រ・ិ・ទ・្・វ・ិ・រ・ត・្・ត
ឧត្តរិទ្វិរត្ត	ឧ・ត・្・ត・រ・ិ・ទ・្・វ・ិ・រ・ត・្・ត
ឧត្តរិភង្គ	ឧ・ត・្・ត・រ・ិ・ភ・ង・្・គ
ឧត្តរិមគ្គ	ឧ・ត・្・ត・រ・ិ・ម・គ・្・គ
ឧត្តរិមនុស្ស	ឧ・ត・្・ត・រ・ិ・ម・ន・ុ・ស・្・ស
ឧត្តរិមនុស្សធម្ម	ឧ・ត・្・ត・រ・ិ・ម・ន・ុ・ស・្・ស・ធ・ម・្・ម
ឧត្តរិលាភ	ឧ・ត・្・ត・រ・ិ・ល・ា・ភ
ឧត្តរិ—	ឧ・ត・្・ត・រ・ិ・—
ឧត្តរោ	ឧ・ត・្・ត・រ・ោ
ឧត្តរំ	ឧ・ត・្・ត・រ・ំ
ឧត្តល	ឧ・ត・្・ត・ល
ឧត្តលា	ឧ・ត・្・ត・ល・ា
ឧត្តលោ	ឧ・ត・្・ត・ល・ោ
ឧត្តាន	ឧ・ត・្・ត・ា・ន
ឧត្តានកថា	ឧ・ត・្・ត・ា・ន・ក・ថ・ា
ឧត្តានការណ៍	ឧ・ត・្・ត・ា・ន・ក・ា・រ・ណ・៍
ឧត្តានចិន្តា	ឧ・ត・្・ត・ា・ន・ច・ិ・ន・្・ត・ា
ឧត្តានភាព	ឧ・ត・្・ត・ា・ន・ភ・ា・ព
ឧត្តានមតិ	ឧ・ត・្・ត・ា・ន・ម・ត・ិ
ឧត្តានសេយ្យា	ឧ・ត・្・ត・ា・ន・ស・េ・យ・្・យ・ា
ឧត្តាន—	ឧ・ត・្・ត・ា・ន・—
ឧត្តាស	ឧ・ត・្・ត・ា・ស
ឧត្តាសការណ៍	ឧ・ត・្・ត・ា・ស・ក・ា・រ・ណ・៍
ឧត្តាសចិត្ត	ឧ・ត・្・ត・ា・ស・ច・ិ・ត・្・ត
ឧត្តាសចិត្ត	ឧ・ត・្・ត・ា・ស・ច・ិ・ត・្・ត
ឧត្តាសដ្ឋាន	ឧ・ត・្・ត・ា・ស・ដ・្・ឋ・ា・ន
ឧត្តាសនីយដ្ឋាន	ឧ・ត・្・ត・ា・ស・ន・ី・យ・ដ・្・ឋ・ា・ន
ឧត្តាសភាព	ឧ・ត・្・ត・ា・ស・ភ・ា・ព
ឧត្រាសចិត្ត	ឧ・ត・្・រ・ា・ស・ច・ិ・ត・្・ត
ឧត្តាស—	ឧ・ត・្・ត・ា・ស・—
ឧត្តាសៈ	ឧ・ត・្・ត・ា・ស・ៈ
ឧត្តុង្គ	ឧ・ត・្・ត・ុ・ង・្・គ
ឧត្តុង្គឧត្តម	ឧ・ត・្・ត・ុ・ង・្・គ・ឧ・ត・្・ត・ម
ឧត្តុង្គឧត្តម	ឧ・ត・្・ត・ុ・ង・្・គ・ឧ・ត・្・ត・ម
ឧទ្ទេសភត្ត	ឧ・ទ・្・ទ・េ・ស・ភ・ត・្・ត
ឧទ្ធច្ចចិត្ត	ឧ・ទ・្・ធ・ច・្・ច・ច・ិ・ត・្・ត
ឧទ្ធច្ចសម្បយុត្ត	ឧ・ទ・្・ធ・ច・្・ច・ស・ម・្・ប・យ・ុ・ត・្・ត
ឧបចារវត្ត	ឧ・ប・ច・ា・រ・វ・ត・្・ត
ឧបជ្ឈាយវត្ត	ឧ・ប・ជ・្・ឈ・ា・យ・វ・ត・្・ត
មិត្តូបត្ថម្ភ	ម・ិ・ត・្・ត・ូ・ប・ត・្・ថ・ម・្・ភ
មិត្តោបត្ថម្ភ	ម・ិ・ត・្・ត・ោ・ប・ត・្・ថ・ម・្・ភ
ឧបនិស្សយសម្បត្តិ	ឧ・ប・ន・ិ・ស・្・ស・យ・ស・ម・្・ប・ត・្・ត・ិ
ឧបបាតិកសត្ត	ឧ・ប・ប・ា・ត・ិ・ក・ស・ត・្・ត
ឧបាសកប្បដិបត្តិ	ឧ・ប・ា・ស・ក・ប・្・ប・ដ・ិ・ប・ត・្・ត・ិ
ឧបាសកប្រតិបត្តិ	ឧ・ប・ា・ស・ក・ប・្・រ・ត・ិ・ប・ត・្・ត・ិ
ឧបាសកសម្បត្តិ	ឧ・ប・ា・ស・ក・ស・ម・្・ប・ត・្・ត・ិ
ឧបេក្ខាសម្បយុត្ត	ឧ・ប・េ・ក・្・ខ・ា・ស・ម・្・ប・យ・ុ・ត・្・ត
ឧបោសថាគារវត្ត	ឧ・ប・ោ・ស・ថ・ា・គ・ា・រ・វ・ត・្・ត
ឧបោសថិកភត្ត	ឧ・ប・ោ・ស・ថ・ិ・ក・ភ・ត・្・ត
ឧប្បត្តិ	ឧ・ប・្・ប・ត・្・ត・ិ
ឧប្បត្តិកថា	ឧ・ប・្・ប・ត・្・ត・ិ・ក・ថ・ា
ឧប្បត្តិកេតនៈ	ឧ・ប・្・ប・ត・្・ត・ិ・ក・េ・ត・ន・ៈ
ឧប្បត្តិកេតន៍	ឧ・ប・្・ប・ត・្・ត・ិ・ក・េ・ត・ន・៍
ឧប្បត្តិភាព	ឧ・ប・្・ប・ត・្・ត・ិ・ភ・ា・ព
ឧប្បត្តិ—	ឧ・ប・្・ប・ត・្・ត・ិ・—
ឧប្បត្តិក	ឧ・ប・្・ប・ត・្・ត・ិ・ក
ឧប្បត្តិកអាចារ្យ	ឧ・ប・្・ប・ត・្・ត・ិ・ក・អ・ា・ច・ា・រ・្・យ
ឧប្បត្តិក	ឧ・ប・្・ប・ត・្・ត・ិ・ក
ឧប្បត្តិការណ៍	ឧ・ប・្・ប・ត・្・ត・ិ・ក・ា・រ・ណ・៍
ឧប្បត្តិហេតុ	ឧ・ប・្・ប・ត・្・ត・ិ・ហ・េ・ត・ុ
ឧប្បលបត្ត	ឧ・ប・្・ប・ល・ប・ត・្・ត
ឧភយពាក្យបរិវត្តន៍	ឧ・ភ・យ・ព・ា・ក・្・យ・ប・រ・ិ・វ・ត・្・ត・ន・៍
ឧភយវាក្យបរិវត្តន៍	ឧ・ភ・យ・វ・ា・ក・្・យ・ប・រ・ិ・វ・ត・្・ត・ន・៍
ឧមានិមិត្ត	ឧ・ម・ា・ន・ិ・ម・ិ・ត・្・ត
ឧម្មត្តក	ឧ・ម・្・ម・ត・្・ត・ក
ទិដ្ឋុម្មត្តកៈ	ទ・ិ・ដ・្・ឋ・ុ・ម・្・ម・ត・្・ត・ក・ៈ
បិត្តុម្មត្តកៈ	ប・ិ・ត・្・ត・ុ・ម・្・ម・ត・្・ត・ក・ៈ
បិត្តុម្មត្តកៈ	ប・ិ・ត・្・ត・ុ・ម・្・ម・ត・្・ត・ក・ៈ
បិសាចុម្មត្តកៈ	ប・ិ・ស・ា・ច・ុ・ម・្・ម・ត・្・ត・ក・ៈ
យក្ខុម្មត្តកៈ	យ・ក・្・ខ・ុ・ម・្・ម・ត・្・ត・ក・ៈ
សុរុម្មត្តកៈ	ស・ុ・រ・ុ・ម・្・ម・ត・្・ត・ក・ៈ
អក្ខធុត្តុម្មត្តកៈ	អ・ក・្・ខ・ធ・ុ・ត・្・ត・ុ・ម・្・ម・ត・្・ត・ក・ៈ
អក្ខធុត្តុម្មត្តកៈ	អ・ក・្・ខ・ធ・ុ・ត・្・ត・ុ・ម・្・ម・ត・្・ត・ក・ៈ
អបាយមុខុម្មត្តកៈ	អ・ប・ា・យ・ម・ុ・ខ・ុ・ម・្・ម・ត・្・ត・ក・ៈ
ឧម្មត្តកភាព	ឧ・ម・្・ម・ត・្・ត・ក・ភ・ា・ព
ឧម្មត្តក–	ឧ・ម・្・ម・ត・្・ត・ក・–
ឧម្មត្តកោ	ឧ・ម・្・ម・ត・្・ត・ក・ោ
ឧម្មត្តកៈ	ឧ・ម・្・ម・ត・្・ត・ក・ៈ
ឧម្មត្តិកា	ឧ・ម・្・ម・ត・្・ត・ិ・ក・ា
ឧរគសត្ត	ឧ・រ・គ・ស・ត・្・ត
ឧឡារសត្ត	ឧ・ឡ・ា・រ・ស・ត・្・ត
ឯកចិត្ត	ឯ・ក・ច・ិ・ត・្・ត
ឯកទត្ត	ឯ・ក・ទ・ត・្・ត
ឯកនេត្ត	ឯ・ក・ន・េ・ត・្・ត
ឯកបុត្ត	ឯ・ក・ប・ុ・ត・្・ត
ឯកភត្តិក	ឯ・ក・ភ・ត・្・ត・ិ・ក
ឯកភត្តិកា	ឯ・ក・ភ・ត・្・ត・ិ・ក・ា
ឯកភត្តិកៈ	ឯ・ក・ភ・ត・្・ត・ិ・ក・ៈ
ឯករត្តិ	ឯ・ក・រ・ត・្・ត・ិ
ឯកត្តជន	ឯ・ក・ត・្・ត・ជ・ន
ឯកត្តភាព	ឯ・ក・ត・្・ត・ភ・ា・ព
ឯកត្តរដ្ឋ	ឯ・ក・ត・្・ត・រ・ដ・្・ឋ
ឯកពីជបត្តជាតិ	ឯ・ក・ព・ី・ជ・ប・ត・្・ត・ជ・ា・ត・ិ
ឯកឧត្តម	ឯ・ក・ឧ・ត・្・ត・ម
ឯកឧត្តម	ឯ・ក・ឧ・ត・្・ត・ម
ឯកុម្មត្ត	ឯ・ក・ុ・ម・្・ម・ត・្・ត
ឱត្តប្ប	ឱ・ត・្・ត・ប・្・ប
ឱត្តប្បៈ	ឱ・ត・្・ត・ប・្・ប・ៈ
ឱទកសត្ត	ឱ・ទ・ក・ស・ត・្・ត
ឱបបាតិកសត្ត	ឱ・ប・ប・ា・ត・ិ・ក・ស・ត・្・ត
ឱភាសនិមិត្ត	ឱ・ភ・ា・ស・ន・ិ・ម・ិ・ត・្・ត
ឱមកសត្ត	ឱ・ម・ក・ស・ត・្・ត
ឱមសត្ត	ឱ・ម・ស・ត・្・ត
តាមអំណាចចិត្ត	ត・ា・ម・អ・ំ・ណ・ា・ច・ច・ិ・ត・្・ត
អំណាចនីតិបញ្ញត្តិ	អ・ំ・ណ・ា・ច・ន・ី・ត・ិ・ប・ញ・្・ញ・ត・្・ត・ិ
អំណាចនីតិប្បញ្ញត្តិ	អ・ំ・ណ・ា・ច・ន・ី・ត・ិ・ប・្・ប・ញ・្・ញ・ត・្・ត・ិ
អំណាចនីតិប្រតិបត្តិ	អ・ំ・ណ・ា・ច・ន・ី・ត・ិ・ប・្・រ・ត・ិ・ប・ត・្・ត・ិ
ខេត្ត	ខ・េ・ត・្・ត
ចក្រពត្តិនិយម	ច・ក・្・រ・ព・ត・្・ត・ិ・ន・ិ・យ・ម
ចិត្ត	ច・ិ・ត・្・ត
ចិត្ត	ច・ិ・ត・្・ត
ចិត្ត	ច・ិ・ត・្・ត
ចិត្តសាស្ត្រ	ច・ិ・ត・្・ត・ស・ា・ស・្・ត・្・រ
នរោត្តម	ន・រ・ោ・ត・្・ត・ម
និមិត្ត	ន・ិ・ម・ិ・ត・្・ត
និមុត្តិធានា	ន・ិ・ម・ុ・ត・្・ត・ិ・ធ・ា・ន・ា
និរុត្តិសាស្ត្រ	ន・ិ・រ・ុ・ត・្・ត・ិ・ស・ា・ស・្・ត・្・រ
បកវត្ត	ប・ក・វ・ត・្・ត
បដិបត្តិ	ប・ដ・ិ・ប・ត・្・ត・ិ
បរិចត្តបុគ្គល	ប・រ・ិ・ច・ត・្・ត・ប・ុ・គ・្・គ・ល
ប្រតិបត្តិ	ប・្・រ・ត・ិ・ប・ត・្・ត・ិ
ប្រព្រឹត្ត	ប・្・រ・ព・្・រ・ឹ・ត・្・ត
ប្រយោគវិបត្តិ	ប・្・រ・យ・ោ・គ・វ・ិ・ប・ត・្・ត・ិ
ប្រយោគសម្បត្តិ	ប・្・រ・យ・ោ・គ・ស・ម・្・ប・ត・្・ត・ិ
ព្រឹត្តិ	ព・្・រ・ឹ・ត・្・ត・ិ
ព្រឹត្តិ	ព・្・រ・ឹ・ត・្・ត・ិ
មេត្តា	ម・េ・ត・្・ត・ា
យាបនមត្ត	យ・ា・ប・ន・ម・ត・្・ត
យុត្តាធិការ	យ・ុ・ត・្・ត・ា・ធ・ិ・ក・ា・រ
យុត្តិធម៌	យ・ុ・ត・្・ត・ិ・ធ・ម・៌
រត្តិចរ	រ・ត・្・ត・ិ・ច・រ
រត្តិចរ	រ・ត・្・ត・ិ・ច・រ
លុត្ត	ល・ុ・ត・្・ត
វត្ត	វ・ត・្・ត
វសវត្តី	វ・ស・វ・ត・្・ត・ី
វិក្ខិត្តចិត្ត	វ・ិ・ក・្・ខ・ិ・ត・្・ត・ច・ិ・ត・្・ត
វិក្ខិត្តចិត្ត	វ・ិ・ក・្・ខ・ិ・ត・្・ត・ច・ិ・ត・្・ត
វិចចិត្ត	វ・ិ・ច・ច・ិ・ត・្・ត
វិមុត្តចិត្ត	វ・ិ・ម・ុ・ត・្・ត・ច・ិ・ត・្・ត
វិមុត្តចិត្ត	វ・ិ・ម・ុ・ត・្・ត・ច・ិ・ត・្・ត
វុត្ត	វ・ុ・ត・្・ត
សគោត្ត	ស・គ・ោ・ត・្・ត
សត្តប្បករណ៍	ស・ត・្・ត・ប・្・ប・ក・រ・ណ・៍
សមាបត្តិ	ស・ម・ា・ប・ត・្・ត・ិ
សុត្តីយភាព	ស・ុ・ត・្・ត・ី・យ・ភ・ា・ព
ហដ្ឋចិត្ត	ហ・ដ・្・ឋ・ច・ិ・ត・្・ត
អញ្ញបដិបត្តិ	អ・ញ・្・ញ・ប・ដ・ិ・ប・ត・្・ត・ិ
អត្តាធីនភាព	អ・ត・្・ត・ា・ធ・ី・ន・ភ・ា・ព
អត្តាវសី	អ・ត・្・ត・ា・វ・ស・ី
អនត្តា	អ・ន・ត・្・ត・ា
អនុត្តរភាព	អ・ន・ុ・ត・្・ត・រ・ភ・ា・ព
យកអរុណក្នុងវត្ត	យ・ក・អ・រ・ុ・ណ・ក・្・ន・ុ・ង・វ・ត・្・ត
អហោរត្ត	អ・ហ・ោ・រ・ត・្・ត
អាចរិយមត្ត	អ・ា・ច・រ・ិ・យ・ម・ត・្・ត
អាណត្តិ	អ・ា・ណ・ត・្・ត・ិ
ឥន្ទបត្ត	ឥ・ន・្・ទ・ប・ត・្・ត
ឧត្តមបុរស	ឧ・ត・្・ត・ម・ប・ុ・រ・ស
ឧត្តមភេទ	ឧ・ត・្・ត・ម・ភ・េ・ទ
ឧត្តរាសង្គ	ឧ・ត・្・ត・រ・ា・ស・ង・្・គ
ឧត្តរិ	ឧ・ត・្・ត・រ・ិ
ឧប្បត្តិ	ឧ・ប・្・ប・ត・្・ត・ិ
ឧប្បត្តិក	ឧ・ប・្・ប・ត・្・ត・ិ・ក
ឧប្បត្តិក	ឧ・ប・្・ប・ត・្・ត・ិ・ក
ឧឡារសត្ត	ឧ・ឡ・ា・រ・ស・ត・្・ត
ឯកចិត្ត	ឯ・ក・ច・ិ・ត・្・ត
