សេចក្តីសំរេចចិត្ត	ស・េ・ច・ក・្・ត・ី・ស・ំ・រ・េ・ច・ច・ិ・ត・្・ត
ក្តាប់	ក・្・ត・ា・ប・់
សេចក្តីប្រាថ្នា	ស・េ・ច・ក・្・ត・ី・ប・្・រ・ា・ថ・្・ន・ា
សេចក្តីថ្លែង	ស・េ・ច・ក・្・ត・ី・ថ・្・ល・ែ・ង
សេចក្តីអំណរ	ស・េ・ច・ក・្・ត・ី・អ・ំ・ណ・រ
ជើងក្តី	ជ・ើ・ង・ក・្・ត・ី
ភក្ត្រ	ភ・ក・្・ត・្・រ
ក្តុលក្រោម	ក・្・ត・ុ・ល・ក・្・រ・ោ・ម
សេចក្តីត្រេកអរ	ស・េ・ច・ក・្・ត・ី・ត・្・រ・េ・ក・អ・រ
បាក់ក្តោង	ប・ា・ក・់・ក・្・ត・ោ・ង
ក្តៅ	ក・្・ត・ៅ
ព្រៃក្តួច	ព・្・រ・ៃ・ក・្・ត・ួ・ច
សេចក្តីទុក្ខ	ស・េ・ច・ក・្・ត・ី・ទ・ុ・ក・្・ខ
ដងក្តារ	ដ・ង・ក・្・ត・ា・រ
ស្វាមីភ័ក្តិ	ស・្・វ・ា・ម・ី・ភ・័・ក・្・ត・ិ
សក្តិយស	ស・ក・្・ត・ិ・យ・ស
កែវមុក្តា	ក・ែ・វ・ម・ុ・ក・្・ត・ា
សេចក្តី	ស・េ・ច・ក・្・ត・ី
ក្តីខ្វាវ	ក・្・ត・ី・ខ・្・វ・ា・វ
ទួលក្តី	ទ・ួ・ល・ក・្・ត・ី
ព្រៃក្តីក្រោម	ព・្・រ・ៃ・ក・្・ត・ី・ក・្・រ・ោ・ម
ក្តាញ់	ក・្・ត・ា・ញ・់
ក្តុលដូនទាវ	ក・្・ត・ុ・ល・ដ・ូ・ន・ទ・ា・វ
សេចក្តីប្រកាស	ស・េ・ច・ក・្・ត・ី・ប・្・រ・ក・ា・ស
សេចក្តីសង្ឃឹម	ស・េ・ច・ក・្・ត・ី・ស・ង・្・ឃ・ឹ・ម
មានសក្តា	ម・ា・ន・ស・ក・្・ត・ា
ព្រៃភក្តី	ព・្・រ・ៃ・ភ・ក・្・ត・ី
ក្តាន់	ក・្・ត・ា・ន・់
ដឹងសេចក្តី	ដ・ឹ・ង・ស・េ・ច・ក・្・ត・ី
ក្តារមឈូស	ក・្・ត・ា・រ・ម・ឈ・ូ・ស
សិទ្ធិស័ក្តិ	ស・ិ・ទ・្・ធ・ិ・ស・័・ក・្・ត・ិ
ព្រៃក្តី	ព・្・រ・ៃ・ក・្・ត・ី
វត្តក្តី	វ・ត・្・ត・ក・្・ត・ី
ក្បាលក្តួច	ក・្・ប・ា・ល・ក・្・ត・ួ・ច
រឿងក្តី	រ・ឿ・ង・ក・្・ត・ី
ព្រះភ័ក្ត្រ	ព・្・រ・ះ・ភ・័・ក・្・ត・្・រ
សេចក្តីស្នេហា	ស・េ・ច・ក・្・ត・ី・ស・្・ន・េ・ហ・ា
កូនក្តី	ក・ូ・ន・ក・្・ត・ី
ចែងក្តារ	ច・ែ・ង・ក・្・ត・ា・រ
ល័ក្ត	ល・័・ក・្・ត
យសស័ក្តិ	យ・ស・ស・័・ក・្・ត・ិ
ក្ដោបក្តាប់	ក・្・ដ・ោ・ប・ក・្・ត・ា・ប・់
ក្តុលជ្រំ	ក・្・ត・ុ・ល・ជ・្・រ・ំ
ភក្តិ	ភ・ក・្・ត・ិ
សរុបសេចក្តីទៅ	ស・រ・ុ・ប・ស・េ・ច・ក・្・ត・ី・ទ・ៅ
ព្រែកក្តី	ព・្・រ・ែ・ក・ក・្・ត・ី
ក្តាមហា	ក・្・ត・ា・ម・ហ・ា
ក្តីចាស់	ក・្・ត・ី・ច・ា・ស・់
ក្តីបឹង	ក・្・ត・ី・ប・ឹ・ង
គោកក្តុល	គ・ោ・ក・ក・្・ត・ុ・ល
ភក្តីភាព	ភ・ក・្・ត・ី・ភ・ា・ព
ស័ក្តិយស	ស・័・ក・្・ត・ិ・យ・ស
ក្តុលលើ	ក・្・ត・ុ・ល・ល・ើ
បំពេញសេចក្តី	ប・ំ・ព・េ・ញ・ស・េ・ច・ក・្・ត・ី
ស្វាយក្តៀប	ស・្・វ・ា・យ・ក・្・ត・ៀ・ប
ស័ក្តិ	ស・័・ក・្・ត・ិ
សេចក្តីរីករាយ	ស・េ・ច・ក・្・ត・ី・រ・ី・ក・រ・ា・យ
អន្សក្តាម	អ・ន・្・ស・ក・្・ត・ា・ម
សក្តិ	ស・ក・្・ត・ិ
នេះក្តី	ន・េ・ះ・ក・្・ត・ី
ក្តាក់	ក・្・ត・ា・ក・់
អំពិលក្តារ	អ・ំ・ព・ិ・ល・ក・្・ត・ា・រ
សក្តិភូមិ	ស・ក・្・ត・ិ・ភ・ូ・ម・ិ
ក្តារខៀន	ក・្・ត・ា・រ・ខ・ៀ・ន
ក្តីស្លា	ក・្・ត・ី・ស・្・ល・ា
ថ្មក្តារ	ថ・្・ម・ក・្・ត・ា・រ
ប្រក់ក្តារ	ប・្・រ・ក・់・ក・្・ត・ា・រ
ក្រាំងក្តី	ក・្・រ・ា・ំ・ង・ក・្・ត・ី
ភ័ក្ត្រ	ភ・័・ក・្・ត・្・រ
ក្តី	ក・្・ត・ី
ក្តីឈ្វិត	ក・្・ត・ី・ឈ・្・វ・ិ・ត
ក្តារ	ក・្・ត・ា・រ
ក្តុលតាហែន	ក・្・ត・ុ・ល・ត・ា・ហ・ែ・ន
ក្តុលផ្សារ	ក・្・ត・ុ・ល・ផ・្・ស・ា・រ
ក្តុក	ក・្・ត・ុ・ក
ដងក្តោង	ដ・ង・ក・្・ត・ោ・ង
មិត្រភក្តិ	ម・ិ・ត・្・រ・ភ・ក・្・ត・ិ
ប៉ោយក្តឿង	ប・៉・ោ・យ・ក・្・ត・ឿ・ង
សក្តា	ស・ក・្・ត・ា
កំពង់ក្តារ	ក・ំ・ព・ង・់・ក・្・ត・ា・រ
ព្រែកក្តាម	ព・្・រ・ែ・ក・ក・្・ត・ា・ម
ដោយសេចក្តីរាប់អាន	ដ・ោ・យ・ស・េ・ច・ក・្・ត・ី・រ・ា・ប・់・អ・ា・ន
ម្តេចក្តី	ម・្・ត・េ・ច・ក・្・ត・ី
តិចក្តីច្រើនក្តី	ត・ិ・ច・ក・្・ត・ី・ច・្・រ・ើ・ន・ក・្・ត・ី
តិចក្តីច្រើនក្តី	ត・ិ・ច・ក・្・ត・ី・ច・្・រ・ើ・ន・ក・្・ត・ី
បុណ្យស័ក្តិ	ប・ុ・ណ・្・យ・ស・័・ក・្・ត・ិ
ក្តេម៉ូត	ក・្・ត・េ・ម・៉・ូ・ត
យសសក្តិ	យ・ស・ស・ក・្・ត・ិ
ក្តឹប	ក・្・ត・ឹ・ប
ក្តិបថ្ម	ក・្・ត・ិ・ប・ថ・្・ម
ក្តិប	ក・្・ត・ិ・ប
យ៉ាងណាក្តី	យ・៉・ា・ង・ណ・ា・ក・្・ត・ី
បុណ្យសក្តិ	ប・ុ・ណ・្・យ・ស・ក・្・ត・ិ
ក្តោយ	ក・្・ត・ោ・យ
សេចក្តីរំភើប	ស・េ・ច・ក・្・ត・ី・រ・ំ・ភ・ើ・ប
សាលាក្តី	ស・ា・ល・ា・ក・្・ត・ី
ក្តីឈ្នួល	ក・្・ត・ី・ឈ・្・ន・ួ・ល
តាក្តុល	ត・ា・ក・្・ត・ុ・ល
ភោក្តា	ភ・ោ・ក・្・ត・ា
អង្គក្តួច	អ・ង・្・គ・ក・្・ត・ួ・ច
ភក្តី	ភ・ក・្・ត・ី
មិត្តភ័ក្តិ	ម・ិ・ត・្・ត・ភ・័・ក・្・ត・ិ
សក្តានុពល	ស・ក・្・ត・ា・ន・ុ・ព・ល
ក្តាន់រយ	ក・្・ត・ា・ន・់・រ・យ
ក្តុកចិត្ត	ក・្・ត・ុ・ក・ច・ិ・ត・្・ត
សមណស័ក្តិ	ស・ម・ណ・ស・័・ក・្・ត・ិ
សេចក្តីពេញចិត្ត	ស・េ・ច・ក・្・ត・ី・ព・េ・ញ・ច・ិ・ត・្・ត
ព្រៃក្តីកណ្តាល	ព・្・រ・ៃ・ក・្・ត・ី・ក・ណ・្・ត・ា・ល
លើសេចក្តី	ល・ើ・ស・េ・ច・ក・្・ត・ី
វង់ភក្ត្រ	វ・ង・់・ភ・ក・្・ត・្・រ
អ្នកក្តី	អ・្・ន・ក・ក・្・ត・ី
ព្រះភក្ត្រ	ព・្・រ・ះ・ភ・ក・្・ត・្・រ
ស័ក្តិសិទ្ធិ	ស・័・ក・្・ត・ិ・ស・ិ・ទ・្・ធ・ិ
ស្គាក្តី	ស・្・គ・ា・ក・្・ត・ី
ក្តីថ្ក	ក・្・ត・ី・ថ・្・ក
ក្តោង	ក・្・ត・ោ・ង
ស័ក្តិសិទ្ធិ​	ស・័・ក・្・ត・ិ・ស・ិ・ទ・្・ធ・ិ・​
សេចក្តីព្រាង	ស・េ・ច・ក・្・ត・ី・ព・្・រ・ា・ង
សេចក្តីអធិប្បាយ	ស・េ・ច・ក・្・ត・ី・អ・ធ・ិ・ប・្・ប・ា・យ
ស័ក្តិសម	ស・័・ក・្・ត・ិ・ស・ម
រកក្តី	រ・ក・ក・្・ត・ី
វត្ថុស័ក្តិសិទ្ធិ	វ・ត・្・ថ・ុ・ស・័・ក・្・ត・ិ・ស・ិ・ទ・្・ធ・ិ
ក្តិច	ក・្・ត・ិ・ច
ត្រពាំងក្តាម	ត・្・រ・ព・ា・ំ・ង・ក・្・ត・ា・ម
មិត្តភក្តិ	ម・ិ・ត・្・ត・ភ・ក・្・ត・ិ
ក្តីរំពឹង	ក・្・ត・ី・រ・ំ・ព・ឹ・ង
កក់ក្តៅ	ក・ក・់・ក・្・ត・ៅ
ក្តាមពុក	ក・្・ត・ា・ម・ព・ុ・ក
ត្រពាំងក្តារ	ត・្・រ・ព・ា・ំ・ង・ក・្・ត・ា・រ
សេចក្តីពិត	ស・េ・ច・ក・្・ត・ី・ព・ិ・ត
ត្រពាំងក្តី	ត・្・រ・ព・ា・ំ・ង・ក・្・ត・ី
ក្តន់	ក・្・ត・ន・់
ក្តុយ	ក・្・ត・ុ・យ
កំពង់ក្តី	ក・ំ・ព・ង・់・ក・្・ត・ី
អង្គក្តី	អ・ង・្・គ・ក・្・ត・ី
ពីសេចក្តី	ព・ី・ស・េ・ច・ក・្・ត・ី
ក្តេរ៉ូថែម	ក・្・ត・េ・រ・៉・ូ・ថ・ែ・ម
សេចក្តីចំរើន	ស・េ・ច・ក・្・ត・ី・ច・ំ・រ・ើ・ន
ត្រគៀបក្តាម	ត・្・រ・គ・ៀ・ប・ក・្・ត・ា・ម
ស័ក្តិធំ	ស・័・ក・្・ត・ិ・ធ・ំ
ក្តីតាចិន	ក・្・ត・ី・ត・ា・ច・ិ・ន
ក្តីតាហុក	ក・្・ត・ី・ត・ា・ហ・ុ・ក
ក្តីតាកុយ	ក・្・ត・ី・ត・ា・ក・ុ・យ
ក្តុម្ពី	ក・្・ត・ុ・ម・្・ព・ី
ក្តួច	ក・្・ត・ួ・ច
ដង្កៀបក្តាម	ដ・ង・្・ក・ៀ・ប・ក・្・ត・ា・ម
សេចក្តីទុកចិត្ត	ស・េ・ច・ក・្・ត・ី・ទ・ុ・ក・ច・ិ・ត・្・ត
សេចក្តីកក់ក្តៅ	ស・េ・ច・ក・្・ត・ី・ក・ក・់・ក・្・ត・ៅ
សេចក្តីកក់ក្តៅ	ស・េ・ច・ក・្・ត・ី・ក・ក・់・ក・្・ត・ៅ
សេក្តី	ស・េ・ក・្・ត・ី
ក្តីរុន	ក・្・ត・ី・រ・ុ・ន
ភ័ក្តិ	ភ・័・ក・្・ត・ិ
កាត់សេចក្តី	ក・ា・ត・់・ស・េ・ច・ក・្・ត・ី
កាត់ក្តី	ក・ា・ត・់・ក・្・ត・ី
ទូលក្តុល	ទ・ូ・ល・ក・្・ត・ុ・ល
ក្តាត	ក・្・ត・ា・ត
ក្តួល	ក・្・ត・ួ・ល
សេចក្តីសុចរិត	ស・េ・ច・ក・្・ត・ី・ស・ុ・ច・រ・ិ・ត
ក្តីត្នោត	ក・្・ត・ី・ត・្・ន・ោ・ត
រាជសក្តិ	រ・ា・ជ・ស・ក・្・ត・ិ
បរិភោក្តា	ប・រ・ិ・ភ・ោ・ក・្・ត・ា
ក្តុល	ក・្・ត・ុ・ល
ក្តីដូង	ក・្・ត・ី・ដ・ូ・ង
ក្តីចារ្យ	ក・្・ត・ី・ច・ា・រ・្・យ
ស្លាបក្តោង	ស・្・ល・ា・ប・ក・្・ត・ោ・ង
ពិភ័ក្តិ	ព・ិ・ភ・័・ក・្・ត・ិ
ក្តួលក្តុក	ក・្・ត・ួ・ល・ក・្・ត・ុ・ក
ក្តួលក្តុក	ក・្・ត・ួ・ល・ក・្・ត・ុ・ក
ត្រពាំងក្តុល	ត・្・រ・ព・ា・ំ・ង・ក・្・ត・ុ・ល
ក្តីមេត្តា	ក・្・ត・ី・ម・េ・ត・្・ត・ា
បានសេចក្តីថា	ប・ា・ន・ស・េ・ច・ក・្・ត・ី・ថ・ា
ក្តោប	ក・្・ត・ោ・ប
ក្តីស្គា	ក・្・ត・ី・ស・្・គ・ា
ឯសេចក្តី	ឯ・ស・េ・ច・ក・្・ត・ី
ក្តីក្តាំ	ក・្・ត・ី・ក・្・ត・ា・ំ
ក្តីក្តាំ	ក・្・ត・ី・ក・្・ត・ា・ំ
ដឹងក្តី	ដ・ឹ・ង・ក・្・ត・ី
បឹងក្តុល	ប・ឹ・ង・ក・្・ត・ុ・ល
លក្តិណា	ល・ក・្・ត・ិ・ណ・ា
ក្តឿងរាយ	ក・្・ត・ឿ・ង・រ・ា・យ
គោកក្តួច	គ・ោ・ក・ក・្・ត・ួ・ច
សេចក្តីត្រូវ	ស・េ・ច・ក・្・ត・ី・ត・្・រ・ូ・វ
ធំដឹងក្តី	ធ・ំ・ដ・ឹ・ង・ក・្・ត・ី
រយៈសេចក្តី	រ・យ・ៈ・ស・េ・ច・ក・្・ត・ី
ត្បូងក្តី	ត・្・ប・ូ・ង・ក・្・ត・ី
