សេចក្តីសំរេចចិត្ត	ស・េ・ច・ក・្・ត・ី・ស・ំ・រ・េ・ច・ច・ិ・ត・្・ត
គួរទុកចិត្ត	គ・ួ・រ・ទ・ុ・ក・ច・ិ・ត・្・ត
អ្នកស្ម័គ្រចិត្ត	អ・្・ន・ក・ស・្・ម・័・គ・្・រ・ច・ិ・ត・្・ត
មុខខេត្ត	ម・ុ・ខ・ខ・េ・ត・្・ត
គាប់ចិត្ត	គ・ា・ប・់・ច・ិ・ត・្・ត
ជើងវត្ត	ជ・ើ・ង・វ・ត・្・ត
ស្រងាកចិត្ត	ស・្・រ・ង・ា・ក・ច・ិ・ត・្・ត
វត្តកណ្តាល	វ・ត・្・ត・ក・ណ・្・ត・ា・ល
ចូលចិត្ត	ច・ូ・ល・ច・ិ・ត・្・ត
ឧត្តមសេនីយ៍ទោ	ឧ・ត・្・ត・ម・ស・េ・ន・ី・យ・៍・ទ・ោ
នឹកក្នុងចិត្ត	ន・ឹ・ក・ក・្・ន・ុ・ង・ច・ិ・ត・្・ត
វត្តជ្រែ	វ・ត・្・ត・ជ・្・រ・ែ
សមានចិត្ត	ស・ម・ា・ន・ច・ិ・ត・្・ត
ខ្លាចចិត្ត	ខ・្・ល・ា・ច・ច・ិ・ត・្・ត
គ្រងរាជសម្បត្តិ	គ・្・រ・ង・រ・ា・ជ・ស・ម・្・ប・ត・្・ត・ិ
វត្ត	វ・ត・្・ត
ស្វ័យប្រវត្តិ	ស・្・វ・័・យ・ប・្・រ・វ・ត・្・ត・ិ
វត្តរំដួល	វ・ត・្・ត・រ・ំ・ដ・ួ・ល
កិច្ចប្រតិបត្តិ	ក・ិ・ច・្・ច・ប・្・រ・ត・ិ・ប・ត・្・ត・ិ
មានចិត្តជា	ម・ា・ន・ច・ិ・ត・្・ត・ជ・ា
ជ្រៃឧត្តម	ជ・្・រ・ៃ・ឧ・ត・្・ត・ម
ចិត្តរំភើប	ច・ិ・ត・្・ត・រ・ំ・ភ・ើ・ប
មុខវត្ត	ម・ុ・ខ・វ・ត・្・ត
តាមចិត្តចង់	ត・ា・ម・ច・ិ・ត・្・ត・ច・ង・់
នីតិបញ្ញត្តិ	ន・ី・ត・ិ・ប・ញ・្・ញ・ត・្・ត・ិ
អនុត្តរភាព	អ・ន・ុ・ត・្・ត・រ・ភ・ា・ព
យាងឧត្តម	យ・ា・ង・ឧ・ត・្・ត・ម
យកចិត្តគេ	យ・ក・ច・ិ・ត・្・ត・គ・េ
ការសម្រេចចិត្ត	ក・ា・រ・ស・ម・្・រ・េ・ច・ច・ិ・ត・្・ត
ព្រះករុណាមេត្តា	ព・្・រ・ះ・ក・រ・ុ・ណ・ា・ម・េ・ត・្・ត・ា
វត្តត្រាច	វ・ត・្・ត・ត・្・រ・ា・ច
ដាក់ចិត្ត	ដ・ា・ក・់・ច・ិ・ត・្・ត
ចិត្តក្ដៅ	ច・ិ・ត・្・ត・ក・្・ដ・ៅ
មាតុភូមិនិវត្តន៍	ម・ា・ត・ុ・ភ・ូ・ម・ិ・ន・ិ・វ・ត・្・ត・ន・៍
ព្រឹត្តិន័យ	ព・្・រ・ឹ・ត・្・ត・ិ・ន・័・យ
ជួយលើកទឹកចិត្ត	ជ・ួ・យ・ល・ើ・ក・ទ・ឹ・ក・ច・ិ・ត・្・ត
សោតាបត្តិផល	ស・ោ・ត・ា・ប・ត・្・ត・ិ・ផ・ល
វត្តគរ	វ・ត・្・ត・គ・រ
មិត្តសម្លាញ់	ម・ិ・ត・្・ត・ស・ម・្・ល・ា・ញ・់
ឧត្តុង្គ	ឧ・ត・្・ត・ុ・ង・្・គ
ប្រវត្តិវិទូ	ប・្・រ・វ・ត・្・ត・ិ・វ・ិ・ទ・ូ
វត្តអារាម	វ・ត・្・ត・អ・ា・រ・ា・ម
ចិត្តស្មោះ	ច・ិ・ត・្・ត・ស・្・ម・ោ・ះ
ព្រឹត្តិប័ត្រ	ព・្・រ・ឹ・ត・្・ត・ិ・ប・័・ត・្・រ
ទប់ចិត្ត	ទ・ប・់・ច・ិ・ត・្・ត
អាក់អន់ចិត្ត	អ・ា・ក・់・អ・ន・់・ច・ិ・ត・្・ត
ទួលសម្បត្តិ	ទ・ួ・ល・ស・ម・្・ប・ត・្・ត・ិ
ចិត្តសុភាព	ច・ិ・ត・្・ត・ស・ុ・ភ・ា・ព
នក្ខត្ត	ន・ក・្・ខ・ត・្・ត
អាណត្តិ	អ・ា・ណ・ត・្・ត・ិ
ចិត្តថ្លើម	ច・ិ・ត・្・ត・ថ・្・ល・ើ・ម
ចិត្តអន្យតិរ្ថិយ	ច・ិ・ត・្・ត・អ・ន・្・យ・ត・ិ・រ・្・ថ・ិ・យ
ព្រះបាទនរោត្តម	ព・្・រ・ះ・ប・ា・ទ・ន・រ・ោ・ត・្・ត・ម
សមត្ត	ស・ម・ត・្・ត
សប្បាយចិត្ត	ស・ប・្・ប・ា・យ・ច・ិ・ត・្・ត
ចរិយាសម្បត្តិ	ច・រ・ិ・យ・ា・ស・ម・្・ប・ត・្・ត・ិ
ជំងឺចិត្ត	ជ・ំ・ង・ឺ・ច・ិ・ត・្・ត
អង្គបញ្ញត្តិ	អ・ង・្・គ・ប・ញ・្・ញ・ត・្・ត・ិ
សុវត្តិភាព	ស・ុ・វ・ត・្・ត・ិ・ភ・ា・ព
វត្តកនឺ្ទ	វ・ត・្・ត・ក・ន・ឺ・្・ទ
ឧត្តុង្គឧត្ដម	ឧ・ត・្・ត・ុ・ង・្・គ・ឧ・ត・្・ដ・ម
ចិត្ត	ច・ិ・ត・្・ត
ឥន្ទបត្ត	ឥ・ន・្・ទ・ប・ត・្・ត
និមិត្តថ្មី	ន・ិ・ម・ិ・ត・្・ត・ថ・្・ម・ី
បរិវត្តន៍	ប・រ・ិ・វ・ត・្・ត・ន・៍
អមិត្តភាព	អ・ម・ិ・ត・្・ត・ភ・ា・ព
អយុត្តិធម៌	អ・យ・ុ・ត・្・ត・ិ・ធ・ម・៌
ចំណូលចិត្ត	ច・ំ・ណ・ូ・ល・ច・ិ・ត・្・ត
មានបំណងចិត្ត	ម・ា・ន・ប・ំ・ណ・ង・ច・ិ・ត・្・ត
លោកុប្បត្តិ	ល・ោ・ក・ុ・ប・្・ប・ត・្・ត・ិ
ចិត្តបុណ្យ	ច・ិ・ត・្・ត・ប・ុ・ណ・្・យ
អត្តពលកម្ម	អ・ត・្・ត・ព・ល・ក・ម・្・ម
សំយុត្តនិកាយ	ស・ំ・យ・ុ・ត・្・ត・ន・ិ・ក・ា・យ
នរោត្តម	ន・រ・ោ・ត・្・ត・ម
វិវិត្ត	វ・ិ・វ・ិ・ត・្・ត
កាត់ចិត្ត	ក・ា・ត・់・ច・ិ・ត・្・ត
រូបសម្បត្តិ	រ・ូ・ប・ស・ម・្・ប・ត・្・ត・ិ
ពុទ្ធប្រវត្តិ	ព・ុ・ទ・្・ធ・ប・្・រ・វ・ត・្・ត・ិ
ចិត្តអាណិតអាសូរ	ច・ិ・ត・្・ត・អ・ា・ណ・ិ・ត・អ・ា・ស・ូ・រ
ចៅអធិការវត្ត	ច・ៅ・អ・ធ・ិ・ក・ា・រ・វ・ត・្・ត
វត្តតាមឹម	វ・ត・្・ត・ត・ា・ម・ឹ・ម
គតិយុត្តិធម៌	គ・ត・ិ・យ・ុ・ត・្・ត・ិ・ធ・ម・៌
បដិវត្តន៍	ប・ដ・ិ・វ・ត・្・ត・ន・៍
ក្រែងចិត្ត	ក・្・រ・ែ・ង・ច・ិ・ត・្・ត
គុត្តសត	គ・ុ・ត・្・ត・ស・ត
កិត្តិ	ក・ិ・ត・្・ត・ិ
ឧប្បត្តិ	ឧ・ប・្・ប・ត・្・ត・ិ
ខាំមាត់សង្កត់ចិត្ត	ខ・ា・ំ・ម・ា・ត・់・ស・ង・្・ក・ត・់・ច・ិ・ត・្・ត
ចិត្តរន្ធត់	ច・ិ・ត・្・ត・រ・ន・្・ធ・ត・់
ច័ន្ទនិមិត្ត	ច・័・ន・្・ទ・ន・ិ・ម・ិ・ត・្・ត
រំភើបចិត្ត	រ・ំ・ភ・ើ・ប・ច・ិ・ត・្・ត
អស់ចិត្តអស់ថ្លើម	អ・ស・់・ច・ិ・ត・្・ត・អ・ស・់・ថ・្・ល・ើ・ម
សត្តម	ស・ត・្・ត・ម
វត្តក្តី	វ・ត・្・ត・ក・្・ត・ី
ព្រះរាជខេត្ត	ព・្・រ・ះ・រ・ា・ជ・ខ・េ・ត・្・ត
បរិយត្តិ	ប・រ・ិ・យ・ត・្・ត・ិ
ពេញចិត្ត	ព・េ・ញ・ច・ិ・ត・្・ត
វិបត្តិសេដ្ឋកិច្ច	វ・ិ・ប・ត・្・ត・ិ・ស・េ・ដ・្・ឋ・ក・ិ・ច・្・ច
ទេវបុត្ត	ទ・េ・វ・ប・ុ・ត・្・ត
វត្តថ្មី	វ・ត・្・ត・ថ・្・ម・ី
ចិត្តស៊ូ	ច・ិ・ត・្・ត・ស・៊・ូ
ចិត្តជឿ	ច・ិ・ត・្・ត・ជ・ឿ
ខកចិត្ត	ខ・ក・ច・ិ・ត・្・ត
លំបាកចិត្ត	ល・ំ・ប・ា・ក・ច・ិ・ត・្・ត
តាមទំនើងចិត្ត	ត・ា・ម・ទ・ំ・ន・ើ・ង・ច・ិ・ត・្・ត
ប្រព្រឹត្តអំពើ	ប・្・រ・ព・្・រ・ឹ・ត・្・ត・អ・ំ・ព・ើ
ប្រតិបត្តិ	ប・្・រ・ត・ិ・ប・ត・្・ត・ិ
វណ្ណយុត្ត	វ・ណ・្・ណ・យ・ុ・ត・្・ត
ទាស់ចិត្ត	ទ・ា・ស・់・ច・ិ・ត・្・ត
ទាន់ចិត្ត	ទ・ា・ន・់・ច・ិ・ត・្・ត
អ្នកចូលចិត្ត	អ・្・ន・ក・ច・ូ・ល・ច・ិ・ត・្・ត
បញ្ញត្ត	ប・ញ・្・ញ・ត・្・ត
កោះវត្ត	ក・ោ・ះ・វ・ត・្・ត
វត្តពោធិ៍ទី	វ・ត・្・ត・ព・ោ・ធ・ិ・៍・ទ・ី
បាក់ទឹកចិត្ត	ប・ា・ក・់・ទ・ឹ・ក・ច・ិ・ត・្・ត
អត្តៈ	អ・ត・្・ត・ៈ
បង់ចិត្ត	ប・ង・់・ច・ិ・ត・្・ត
បុត្ត	ប・ុ・ត・្・ត
ស្នួលវត្ត	ស・្・ន・ួ・ល・វ・ត・្・ត
ធម្មយុត្តិ	ធ・ម・្・ម・យ・ុ・ត・្・ត・ិ
បុរេប្រវត្តិ	ប・ុ・រ・េ・ប・្・រ・វ・ត・្・ត・ិ
ចក្រពត្តិនិយម	ច・ក・្・រ・ព・ត・្・ត・ិ・ន・ិ・យ・ម
ចិត្តច្រើន	ច・ិ・ត・្・ត・ច・្・រ・ើ・ន
អត្តចរិត	អ・ត・្・ត・ច・រ・ិ・ត
ចិត្តបាន	ច・ិ・ត・្・ត・ប・ា・ន
វត្តតាមិម	វ・ត・្・ត・ត・ា・ម・ិ・ម
ទុកចិត្ត	ទ・ុ・ក・ច・ិ・ត・្・ត
ជក់ចិត្ត	ជ・ក・់・ច・ិ・ត・្・ត
អត្តទត្ថបុគ្គល	អ・ត・្・ត・ទ・ត・្・ថ・ប・ុ・គ・្・គ・ល
អន្ទងចិត្ត	អ・ន・្・ទ・ង・ច・ិ・ត・្・ត
ព្រះវត្តមាន	ព・្・រ・ះ・វ・ត・្・ត・ម・ា・ន
បត្តាជី	ប・ត・្・ត・ា・ជ・ី
អូរត្រជាក់ចិត្ត	អ・ូ・រ・ត・្・រ・ជ・ា・ក・់・ច・ិ・ត・្・ត
ចិត្តស្រាល	ច・ិ・ត・្・ត・ស・្・រ・ា・ល
ទាញចិត្ត	ទ・ា・ញ・ច・ិ・ត・្・ត
បាយបត្តបូរ	ប・ា・យ・ប・ត・្・ត・ប・ូ・រ
មិត្តភក្ដិ	ម・ិ・ត・្・ត・ភ・ក・្・ដ・ិ
ភត្តានុមោទនា	ភ・ត・្・ត・ា・ន・ុ・ម・ោ・ទ・ន・ា
សេរីសម្បត្តិ	ស・េ・រ・ី・ស・ម・្・ប・ត・្・ត・ិ
និរុត្តិ	ន・ិ・រ・ុ・ត・្・ត・ិ
ទេព្វនិមិត្ត	ទ・េ・ព・្・វ・ន・ិ・ម・ិ・ត・្・ត
អាញត្តិ	អ・ា・ញ・ត・្・ត・ិ
ប្រវត្តិវិទ្យា	ប・្・រ・វ・ត・្・ត・ិ・វ・ិ・ទ・្・យ・ា
យុត្ត	យ・ុ・ត・្・ត
នីតិប្បញ្ញត្តិ	ន・ី・ត・ិ・ប・្・ប・ញ・្・ញ・ត・្・ត・ិ
ចិត្តវិបរិត	ច・ិ・ត・្・ត・វ・ិ・ប・រ・ិ・ត
មនុស្សចិត្ត	ម・ន・ុ・ស・្・ស・ច・ិ・ត・្・ត
ថ្មីឧត្តម	ថ・្・ម・ី・ឧ・ត・្・ត・ម
ឧត្តមភាព	ឧ・ត・្・ត・ម・ភ・ា・ព
ចិត្តរឹង	ច・ិ・ត・្・ត・រ・ឹ・ង
វិបត្តិ	វ・ិ・ប・ត・្・ត・ិ
ចិត្តគំនិត	ច・ិ・ត・្・ត・គ・ំ・ន・ិ・ត
មិត្តភ្ងា	ម・ិ・ត・្・ត・ភ・្・ង・ា
ឧត្តរា	ឧ・ត・្・ត・រ・ា
កិត្តិនាម	ក・ិ・ត・្・ត・ិ・ន・ា・ម
មេវត្ត	ម・េ・វ・ត・្・ត
សម្បត្តិធម្មជាតិ	ស・ម・្・ប・ត・្・ត・ិ・ធ・ម・្・ម・ជ・ា・ត・ិ
រាជ្យសម្បត្តិ	រ・ា・ជ・្・យ・ស・ម・្・ប・ត・្・ត・ិ
ភ្ញៀវកិត្តិយស	ភ・្・ញ・ៀ・វ・ក・ិ・ត・្・ត・ិ・យ・ស
ទ្រព្យសម្បត្តិ	ទ・្・រ・ព・្・យ・ស・ម・្・ប・ត・្・ត・ិ
ជាប់ចិត្ត	ជ・ា・ប・់・ច・ិ・ត・្・ត
ចិត្តល្អ	ច・ិ・ត・្・ត・ល・្・អ
បានចិត្ត	ប・ា・ន・ច・ិ・ត・្・ត
ឥត្ថីធុត្តៈ	ឥ・ត・្・ថ・ី・ធ・ុ・ត・្・ត・ៈ
បែកចិត្ត	ប・ែ・ក・ច・ិ・ត・្・ត
វត្តលួង	វ・ត・្・ត・ល・ួ・ង
អនុញ្ញាត្ត	អ・ន・ុ・ញ・្・ញ・ា・ត・្・ត
ថាចិត្ត	ថ・ា・ច・ិ・ត・្・ត
សម្មាបដិបត្តិ	ស・ម・្・ម・ា・ប・ដ・ិ・ប・ត・្・ត・ិ
សន្តានចិត្ត	ស・ន・្・ត・ា・ន・ច・ិ・ត・្・ត
និមិត្ត	ន・ិ・ម・ិ・ត・្・ត
ចិត្តអាក្រក់	ច・ិ・ត・្・ត・អ・ា・ក・្・រ・ក・់
មេត្តា	ម・េ・ត・្・ត・ា
ខ្លោចចិត្ត	ខ・្・ល・ោ・ច・ច・ិ・ត・្・ត
ចងចិត្ត	ច・ង・ច・ិ・ត・្・ត
ក្មេងវត្ត	ក・្・ម・េ・ង・វ・ត・្・ត
អាចារ្យវត្ត	អ・ា・ច・ា・រ・្・យ・វ・ត・្・ត
សាលាវត្ត	ស・ា・ល・ា・វ・ត・្・ត
ត្រូវអាបត្តិ	ត・្・រ・ូ・វ・អ・ា・ប・ត・្・ត・ិ
ទីវត្ត	ទ・ី・វ・ត・្・ត
វត្តស្លា	វ・ត・្・ត・ស・្・ល・ា
តាមអំពើចិត្ត	ត・ា・ម・អ・ំ・ព・ើ・ច・ិ・ត・្・ត
ស្កប់ចិត្ត	ស・្・ក・ប・់・ច・ិ・ត・្・ត
កិត្តិយស	ក・ិ・ត・្・ត・ិ・យ・ស
និមិត្តសញ្ញា	ន・ិ・ម・ិ・ត・្・ត・ស・ញ・្・ញ・ា
ពិបាកចិត្ត	ព・ិ・ប・ា・ក・ច・ិ・ត・្・ត
ធម្មយុត្ត	ធ・ម・្・ម・យ・ុ・ត・្・ត
ចិត្តខ្លាំង	ច・ិ・ត・្・ត・ខ・្・ល・ា・ំ・ង
កាលានុវត្តន៍	ក・ា・ល・ា・ន・ុ・វ・ត・្・ត・ន・៍
ប្រព្រឹត្តិតាម	ប・្・រ・ព・្・រ・ឹ・ត・្・ត・ិ・ត・ា・ម
ហួសចិត្ត	ហ・ួ・ស・ច・ិ・ត・្・ត
វណ្ណយុត្តិ	វ・ណ・្・ណ・យ・ុ・ត・្・ត・ិ
រង្វាន់លួងចិត្ត	រ・ង・្・វ・ា・ន・់・ល・ួ・ង・ច・ិ・ត・្・ត
ប្រព្រឹត្តិកម្ម	ប・្・រ・ព・្・រ・ឹ・ត・្・ត・ិ・ក・ម・្・ម
យុត្តិ	យ・ុ・ត・្・ត・ិ
ឱត្តប្បៈ	ឱ・ត・្・ត・ប・្・ប・ៈ
និវត្ត	ន・ិ・វ・ត・្・ត
ឧត្តរមានជ័យ	ឧ・ត・្・ត・រ・ម・ា・ន・ជ・័・យ
ឧត្តមសុរិយា	ឧ・ត・្・ត・ម・ស・ុ・រ・ិ・យ・ា
នីតិប្រតិបត្តិ	ន・ី・ត・ិ・ប・្・រ・ត・ិ・ប・ត・្・ត・ិ
ឯកទត្ត	ឯ・ក・ទ・ត・្・ត
ចំណង់ចំណូលចិត្ត	ច・ំ・ណ・ង・់・ច・ំ・ណ・ូ・ល・ច・ិ・ត・្・ត
និវត្តន៍	ន・ិ・វ・ត・្・ត・ន・៍
ឲ្យអស់ចិត្ត	ឲ・្・យ・អ・ស・់・ច・ិ・ត・្・ត
លះកាត់ចិត្ត	ល・ះ・ក・ា・ត・់・ច・ិ・ត・្・ត
បាក់ចិត្ត	ប・ា・ក・់・ច・ិ・ត・្・ត
ខត្ត	ខ・ត・្・ត
វត្តបូព៌	វ・ត・្・ត・ប・ូ・ព・៌
លិចវត្ត	ល・ិ・ច・វ・ត・្・ត
គុណសម្បត្តិ	គ・ុ・ណ・ស・ម・្・ប・ត・្・ត・ិ
ត្រូវចិត្ត	ត・្・រ・ូ・វ・ច・ិ・ត・្・ត
បដិបត្តិ	ប・ដ・ិ・ប・ត・្・ត・ិ
ឧត្តមគតិ	ឧ・ត・្・ត・ម・គ・ត・ិ
ទួលនិមិត្ត	ទ・ួ・ល・ន・ិ・ម・ិ・ត・្・ត
ចៅហ្វាយខេត្ត	ច・ៅ・ហ・្・វ・ា・យ・ខ・េ・ត・្・ត
ចិត្តមេត្តា	ច・ិ・ត・្・ត・ម・េ・ត・្・ត・ា
ចិត្តមេត្តា	ច・ិ・ត・្・ត・ម・េ・ត・្・ត・ា
គោកវត្ត	គ・ោ・ក・វ・ត・្・ត
វិត្ត	វ・ិ・ត・្・ត
ឧត្តមស្នងការ	ឧ・ត・្・ត・ម・ស・្・ន・ង・ក・ា・រ
ការអនុវត្ត	ក・ា・រ・អ・ន・ុ・វ・ត・្・ត
វត្តស្លែង	វ・ត・្・ត・ស・្・ល・ែ・ង
ផ្គាប់ចិត្ត	ផ・្・គ・ា・ប・់・ច・ិ・ត・្・ត
រួមចិត្ត	រ・ួ・ម・ច・ិ・ត・្・ត
ប្រព្រឹត្តអំពើបាប	ប・្・រ・ព・្・រ・ឹ・ត・្・ត・អ・ំ・ព・ើ・ប・ា・ប
មានសម្បត្តិ	ម・ា・ន・ស・ម・្・ប・ត・្・ត・ិ
ឧត្តុង្គឧត្តម	ឧ・ត・្・ត・ុ・ង・្・គ・ឧ・ត・្・ត・ម
ឧត្តុង្គឧត្តម	ឧ・ត・្・ត・ុ・ង・្・គ・ឧ・ត・្・ត・ម
វត្តឧណ្ណាលោម	វ・ត・្・ត・ឧ・ណ・្・ណ・ា・ល・ោ・ម
ប្រព្រឹត្ត	ប・្・រ・ព・្・រ・ឹ・ត・្・ត
សត្ត	ស・ត・្・ត
ការប្រព្រឹត្ត	ក・ា・រ・ប・្・រ・ព・្・រ・ឹ・ត・្・ត
ប្រព្រឹត្តទៅ	ប・្・រ・ព・្・រ・ឹ・ត・្・ត・ទ・ៅ
ឧប្បត្តិហេតុ	ឧ・ប・្・ប・ត・្・ត・ិ・ហ・េ・ត・ុ
ប្របវត្ត	ប・្・រ・ប・វ・ត・្・ត
ស្ងប់ចិត្ត	ស・្・ង・ប・់・ច・ិ・ត・្・ត
ចិត្តទូលាយ	ច・ិ・ត・្・ត・ទ・ូ・ល・ា・យ
ចិត្តស្រឡាញ់	ច・ិ・ត・្・ត・ស・្・រ・ឡ・ា・ញ・់
គុណវិបត្តិ	គ・ុ・ណ・វ・ិ・ប・ត・្・ត・ិ
លើកទឹកចិត្ត	ល・ើ・ក・ទ・ឹ・ក・ច・ិ・ត・្・ត
វត្តិ	វ・ត・្・ត・ិ
ខាងកើតវត្ត	ខ・ា・ង・ក・ើ・ត・វ・ត・្・ត
បែរចិត្ត	ប・ែ・រ・ច・ិ・ត・្・ត
បើកចំហចិត្ត	ប・ើ・ក・ច・ំ・ហ・ច・ិ・ត・្・ត
មិត្តរ៉ាច	ម・ិ・ត・្・ត・រ・៉・ា・ច
វិវត្តន៍	វ・ិ・វ・ត・្・ត・ន・៍
មេត្តាធម៌	ម・េ・ត・្・ត・ា・ធ・ម・៌
វិវត្ត	វ・ិ・វ・ត・្・ត
បញ្ញាចិត្ត	ប・ញ・្・ញ・ា・ច・ិ・ត・្・ត
ចូលចិត្តជាង	ច・ូ・ល・ច・ិ・ត・្・ត・ជ・ា・ង
ចិត្តរីករាយ	ច・ិ・ត・្・ត・រ・ី・ក・រ・ា・យ
សុត្ត	ស・ុ・ត・្・ត
កត្តា	ក・ត・្・ត・ា
មិនអស់ចិត្ត	ម・ិ・ន・អ・ស・់・ច・ិ・ត・្・ត
ចិត្តនឹង	ច・ិ・ត・្・ត・ន・ឹ・ង
មហាសម្បត្តិ	ម・ហ・ា・ស・ម・្・ប・ត・្・ត・ិ
ធម្មយុត្តិកនិកាយ	ធ・ម・្・ម・យ・ុ・ត・្・ត・ិ・ក・ន・ិ・ក・ា・យ
ប៉ោយវត្ត	ប・៉・ោ・យ・វ・ត・្・ត
សម្បត្តិមានជ័យ	ស・ម・្・ប・ត・្・ត・ិ・ម・ា・ន・ជ・័・យ
យុត្តាធិការ	យ・ុ・ត・្・ត・ា・ធ・ិ・ក・ា・រ
ភត្ត	ភ・ត・្・ត
ចិត្តសាស្ត្រ	ច・ិ・ត・្・ត・ស・ា・ស・្・ត・្・រ
កត្តិក	ក・ត・្・ត・ិ・ក
មិត្ត	ម・ិ・ត・្・ត
ប្រវត្តិសាស្ត្រ	ប・្・រ・វ・ត・្・ត・ិ・ស・ា・ស・្・ត・្・រ
អនុវត្តិ	អ・ន・ុ・វ・ត・្・ត・ិ
ខេត្តមណ្ឌលគីរី	ខ・េ・ត・្・ត・ម・ណ・្・ឌ・ល・គ・ី・រ・ី
កំឡាំងចិត្ត	ក・ំ・ឡ・ា・ំ・ង・ច・ិ・ត・្・ត
អស់ពីដួងចិត្ត	អ・ស・់・ព・ី・ដ・ួ・ង・ច・ិ・ត・្・ត
ជឿទុកចិត្ត	ជ・ឿ・ទ・ុ・ក・ច・ិ・ត・្・ត
សុត្តនិបាត	ស・ុ・ត・្・ត・ន・ិ・ប・ា・ត
ប្រវត្តិ	ប・្・រ・វ・ត・្・ត・ិ
ប្រាសាទអង្គរវត្ត	ប・្・រ・ា・ស・ា・ទ・អ・ង・្・គ・រ・វ・ត・្・ត
អ្នកបដិវត្ត	អ・្・ន・ក・ប・ដ・ិ・វ・ត・្・ត
សមចិត្ត	ស・ម・ច・ិ・ត・្・ត
សម្បត្តិមនុស្ស	ស・ម・្・ប・ត・្・ត・ិ・ម・ន・ុ・ស・្・ស
ព្រឹត្តិបត្រ	ព・្・រ・ឹ・ត・្・ត・ិ・ប・ត・្・រ
ញត្តិ	ញ・ត・្・ត・ិ
ចិត្តលុះ	ច・ិ・ត・្・ត・ល・ុ・ះ
វត្តអង្គ	វ・ត・្・ត・អ・ង・្・គ
មិត្តភ័ក្តិ	ម・ិ・ត・្・ត・ភ・័・ក・្・ត・ិ
អនុវត្តន៍	អ・ន・ុ・វ・ត・្・ត・ន・៍
បង្ខំចិត្ត	ប・ង・្・ខ・ំ・ច・ិ・ត・្・ត
អន់ចិត្ត	អ・ន・់・ច・ិ・ត・្・ត
សមមិត្ត	ស・ម・ម・ិ・ត・្・ត
ភាពស្កប់ចិត្ត	ភ・ា・ព・ស・្・ក・ប・់・ច・ិ・ត・្・ត
អស់ចិត្ត	អ・ស・់・ច・ិ・ត・្・ត
និវត្តជន	ន・ិ・វ・ត・្・ត・ជ・ន
ជំរុញចិត្ត	ជ・ំ・រ・ុ・ញ・ច・ិ・ត・្・ត
ក្តុកចិត្ត	ក・្・ត・ុ・ក・ច・ិ・ត・្・ត
សត្តឃាត	ស・ត・្・ត・ឃ・ា・ត
សេចក្តីពេញចិត្ត	ស・េ・ច・ក・្・ត・ី・ព・េ・ញ・ច・ិ・ត・្・ត
ចិត្តខឹង	ច・ិ・ត・្・ត・ខ・ឹ・ង
ទិនានុប្បវត្តិ	ទ・ិ・ន・ា・ន・ុ・ប・្・ប・វ・ត・្・ត・ិ
ចិត្តជា	ច・ិ・ត・្・ត・ជ・ា
និរោធសមាបត្តិ	ន・ិ・រ・ោ・ធ・ស・ម・ា・ប・ត・្・ត・ិ
អនោតត្ត	អ・ន・ោ・ត・ត・្・ត
ឃ្លាំងសម្បត្តិ	ឃ・្・ល・ា・ំ・ង・ស・ម・្・ប・ត・្・ត・ិ
យុត្តិការ	យ・ុ・ត・្・ត・ិ・ក・ា・រ
ទំនុកចិត្ត	ទ・ំ・ន・ុ・ក・ច・ិ・ត・្・ត
បច្ចាមិត្ត	ប・ច・្・ច・ា・ម・ិ・ត・្・ត
លក្ខណសម្បត្តិ	ល・ក・្・ខ・ណ・ស・ម・្・ប・ត・្・ត・ិ
វិមុត្តិ	វ・ិ・ម・ុ・ត・្・ត・ិ
នគរវត្ត	ន・គ・រ・វ・ត・្・ត
រាជប្រវត្តិ	រ・ា・ជ・ប・្・រ・វ・ត・្・ត・ិ
វិបត្តិស្នេហា	វ・ិ・ប・ត・្・ត・ិ・ស・្・ន・េ・ហ・ា
មិត្តរួមជំនាន់	ម・ិ・ត・្・ត・រ・ួ・ម・ជ・ំ・ន・ា・ន・់
យកចិត្ត	យ・ក・ច・ិ・ត・្・ត
ចក្រពត្តិ	ច・ក・្・រ・ព・ត・្・ត・ិ
អាណិតមេត្តា	អ・ា・ណ・ិ・ត・ម・េ・ត・្・ត・ា
វត្តស្វាយ	វ・ត・្・ត・ស・្・វ・ា・យ
វត្តឯកលីផល	វ・ត・្・ត・ឯ・ក・ល・ី・ផ・ល
អ្នកប្រវត្តិសាស្ត្រ	អ・្・ន・ក・ប・្・រ・វ・ត・្・ត・ិ・ស・ា・ស・្・ត・្・រ
វត្តសំប៉ាន	វ・ត・្・ត・ស・ំ・ប・៉・ា・ន
មិត្តជិតដិត	ម・ិ・ត・្・ត・ជ・ិ・ត・ដ・ិ・ត
វត្តភ្នំ	វ・ត・្・ត・ភ・្・ន・ំ
ចិត្តគិត	ច・ិ・ត・្・ត・គ・ិ・ត
ការប្ដេជ្ញាចិត្ត	ក・ា・រ・ប・្・ដ・េ・ជ・្・ញ・ា・ច・ិ・ត・្・ត
ស្រេចតែចិត្ត	ស・្・រ・េ・ច・ត・ែ・ច・ិ・ត・្・ត
វត្តមាន	វ・ត・្・ត・ម・ា・ន
រំជួលចិត្ត	រ・ំ・ជ・ួ・ល・ច・ិ・ត・្・ត
អត្ត	អ・ត・្・ត
ព្រំខេត្ត	ព・្・រ・ំ・ខ・េ・ត・្・ត
វត្តនី	វ・ត・្・ត・ន・ី
អត្តភាព	អ・ត・្・ត・ភ・ា・ព
ចំណងមិត្តភាព	ច・ំ・ណ・ង・ម・ិ・ត・្・ត・ភ・ា・ព
និរុត្តិសាស្ត្រ	ន・ិ・រ・ុ・ត・្・ត・ិ・ស・ា・ស・្・ត・្・រ
ព្រះកិត្តិនាម	ព・្・រ・ះ・ក・ិ・ត・្・ត・ិ・ន・ា・ម
ខេត្ត	ខ・េ・ត・្・ត
និមិត្តរូប	ន・ិ・ម・ិ・ត・្・ត・រ・ូ・ប
ជ័យឧត្តម	ជ・័・យ・ឧ・ត・្・ត・ម
ខាងលិចវត្ត	ខ・ា・ង・ល・ិ・ច・វ・ត・្・ត
ឈឺចិត្ត	ឈ・ឺ・ច・ិ・ត・្・ត
ថ្នាក់ឧត្តម	ថ・្・ន・ា・ក・់・ឧ・ត・្・ត・ម
សហប្រតិបត្តិការ	ស・ហ・ប・្・រ・ត・ិ・ប・ត・្・ត・ិ・ក・ា・រ
ប្រព្រឹត្តិ	ប・្・រ・ព・្・រ・ឹ・ត・្・ត・ិ
ស្មោះអស់ពីចិត្ត	ស・្・ម・ោ・ះ・អ・ស・់・ព・ី・ច・ិ・ត・្・ត
ដោយស្វ័យប្រវត្តិ	ដ・ោ・យ・ស・្・វ・័・យ・ប・្・រ・វ・ត・្・ត・ិ
វត្តដំណាក់	វ・ត・្・ត・ដ・ំ・ណ・ា・ក・់
ការប្រតិបត្តិ	ក・ា・រ・ប・្・រ・ត・ិ・ប・ត・្・ត・ិ
អត្តទត្ថ	អ・ត・្・ត・ទ・ត・្・ថ
ស្លាប់ចិត្ត	ស・្・ល・ា・ប・់・ច・ិ・ត・្・ត
ឧដុង្គឧត្តម	ឧ・ដ・ុ・ង・្・គ・ឧ・ត・្・ត・ម
តូចចិត្ត	ត・ូ・ច・ច・ិ・ត・្・ត
កិត្តិសព្ទ	ក・ិ・ត・្・ត・ិ・ស・ព・្・ទ
បំណងចិត្ត	ប・ំ・ណ・ង・ច・ិ・ត・្・ត
រត្តិ	រ・ត・្・ត・ិ
ពាន់វត្ត	ព・ា・ន・់・វ・ត・្・ត
បទបញ្ញត្តិ	ប・ទ・ប・ញ・្・ញ・ត・្・ត・ិ
គ្មានចិត្ត	គ・្・ម・ា・ន・ច・ិ・ត・្・ត
ក្នុងចិត្ត	ក・្・ន・ុ・ង・ច・ិ・ត・្・ត
ឧត្តមសេនីយ៍	ឧ・ត・្・ត・ម・ស・េ・ន・ី・យ・៍
យល់ចិត្ត	យ・ល・់・ច・ិ・ត・្・ត
ប្ដេជ្ញាចិត្ត	ប・្・ដ・េ・ជ・្・ញ・ា・ច・ិ・ត・្・ត
កោះមិត្ត	ក・ោ・ះ・ម・ិ・ត・្・ត
មិត្តភក្តិ	ម・ិ・ត・្・ត・ភ・ក・្・ត・ិ
គន់គូរនក្ខត្តឫក្ស	គ・ន・់・គ・ូ・រ・ន・ក・្・ខ・ត・្・ត・ឫ・ក・្・ស
អាបត្តិ	អ・ា・ប・ត・្・ត・ិ
បង្អាក់ទឹកចិត្ត	ប・ង・្・អ・ា・ក・់・ទ・ឹ・ក・ច・ិ・ត・្・ត
ចិត្តត្រង់	ច・ិ・ត・្・ត・ត・្・រ・ង・់
កិត្តិគុណ	ក・ិ・ត・្・ត・ិ・គ・ុ・ណ
អត្តសញ្ញាណប័ណ្ណ	អ・ត・្・ត・ស・ញ・្・ញ・ា・ណ・ប・័・ណ・្・ណ
សូមលោកមេត្តា	ស・ូ・ម・ល・ោ・ក・ម・េ・ត・្・ត・ា
ឯកឧត្តម	ឯ・ក・ឧ・ត・្・ត・ម
មិត្តភាព	ម・ិ・ត・្・ត・ភ・ា・ព
ប្រណិបត្តិ	ប・្・រ・ណ・ិ・ប・ត・្・ត・ិ
ត្បូងវត្ត	ត・្・ប・ូ・ង・វ・ត・្・ត
លោកប្រវត្តិ	ល・ោ・ក・ប・្・រ・វ・ត・្・ត・ិ
មជ្ឈត្តកម្ម	ម・ជ・្・ឈ・ត・្・ត・ក・ម・្・ម
ដួងចិត្ត	ដ・ួ・ង・ច・ិ・ត・្・ត
លោកុត្តរ	ល・ោ・ក・ុ・ត・្・ត・រ
វត្តរកា	វ・ត・្・ត・រ・ក・ា
ព្រឹត្តិការណ៍	ព・្・រ・ឹ・ត・្・ត・ិ・ក・ា・រ・ណ・៍
យុត្តិធម៌	យ・ុ・ត・្・ត・ិ・ធ・ម・៌
ខែកត្តិក	ខ・ែ・ក・ត・្・ត・ិ・ក
អត្តសញ្ញាណ	អ・ត・្・ត・ស・ញ・្・ញ・ា・ណ
តាមចំណូលចិត្ត	ត・ា・ម・ច・ំ・ណ・ូ・ល・ច・ិ・ត・្・ត
ប្រតិបត្តិការ	ប・្・រ・ត・ិ・ប・ត・្・ត・ិ・ក・ា・រ
ចិត្តខ្មៅ	ច・ិ・ត・្・ត・ខ・្・ម・ៅ
សម្បត្តិ​	ស・ម・្・ប・ត・្・ត・ិ・​
វរោត្តម	វ・រ・ោ・ត・្・ត・ម
ដោយចិត្ត	ដ・ោ・យ・ច・ិ・ត・្・ត
សមាបត្តិ	ស・ម・ា・ប・ត・្・ត・ិ
សំរោងវត្ត	ស・ំ・រ・ោ・ង・វ・ត・្・ត
វត្តចែង	វ・ត・្・ត・ច・ែ・ង
ចិត្តលោភ	ច・ិ・ត・្・ត・ល・ោ・ភ
ចិត្តសប្បុរស	ច・ិ・ត・្・ត・ស・ប・្・ប・ុ・រ・ស
ឧត្តរកុរុទ្វីប	ឧ・ត・្・ត・រ・ក・ុ・រ・ុ・ទ・្・វ・ី・ប
មានចិត្តលើ	ម・ា・ន・ច・ិ・ត・្・ត・ល・ើ
បដិវត្ត	ប・ដ・ិ・វ・ត・្・ត
គិតក្នុងចិត្ត	គ・ិ・ត・ក・្・ន・ុ・ង・ច・ិ・ត・្・ត
ចាប់ចិត្ត	ច・ា・ប・់・ច・ិ・ត・្・ត
ទឹកចិត្ត	ទ・ឹ・ក・ច・ិ・ត・្・ត
សម្បិត្តិ	ស・ម・្・ប・ិ・ត・្・ត・ិ
អនត្តា	អ・ន・ត・្・ត・ា
មេត្តាប្រោស	ម・េ・ត・្・ត・ា・ប・្・រ・ោ・ស
ឱត្តប្ប	ឱ・ត・្・ត・ប・្・ប
មត្តេយ្យសាលា	ម・ត・្・ត・េ・យ・្・យ・ស・ា・ល・ា
វេទនាចិត្ត	វ・េ・ទ・ន・ា・ច・ិ・ត・្・ត
ភត្តាហារ	ភ・ត・្・ត・ា・ហ・ា・រ
ផ្ចង់ចិត្ត	ផ・្・ច・ង・់・ច・ិ・ត・្・ត
ឧត្តរ	ឧ・ត・្・ត・រ
សុត្តន្តបិដក	ស・ុ・ត・្・ត・ន・្・ត・ប・ិ・ដ・ក
តាមចិត្ត	ត・ា・ម・ច・ិ・ត・្・ត
អត្តឃាត	អ・ត・្・ត・ឃ・ា・ត
វេរភត្ត	វ・េ・រ・ភ・ត・្・ត
ជ័យនិវត្តន៍	ជ・័・យ・ន・ិ・វ・ត・្・ត・ន・៍
អត្តខាត់	អ・ត・្・ត・ខ・ា・ត・់
ប្រវត្តិរូប	ប・្・រ・វ・ត・្・ត・ិ・រ・ូ・ប
ឧត្តម	ឧ・ត・្・ត・ម
ស្ម័គ្រចិត្ត	ស・្・ម・័・គ・្・រ・ច・ិ・ត・្・ត
សេចក្តីទុកចិត្ត	ស・េ・ច・ក・្・ត・ី・ទ・ុ・ក・ច・ិ・ត・្・ត
ស្គាល់ចិត្ត	ស・្・គ・ា・ល・់・ច・ិ・ត・្・ត
មហាមិត្ត	ម・ហ・ា・ម・ិ・ត・្・ត
សង្កត់ចិត្ត	ស・ង・្・ក・ត・់・ច・ិ・ត・្・ត
ជំរុញលើកទឹកចិត្ត	ជ・ំ・រ・ុ・ញ・ល・ើ・ក・ទ・ឹ・ក・ច・ិ・ត・្・ត
វត្តពោធិ៍	វ・ត・្・ត・ព・ោ・ធ・ិ・៍
ខិត្តប័ណ្ណ	ខ・ិ・ត・្・ត・ប・័・ណ・្・ណ
អនុវត្ត	អ・ន・ុ・វ・ត・្・ត
អនត្តសញ្ញា	អ・ន・ត・្・ត・ស・ញ・្・ញ・ា
ទាក់ទាញចិត្ត	ទ・ា・ក・់・ទ・ា・ញ・ច・ិ・ត・្・ត
ចិត្តស្នេហា	ច・ិ・ត・្・ត・ស・្・ន・េ・ហ・ា
វិភត្តិ	វ・ិ・ភ・ត・្・ត・ិ
អត្តពលិក	អ・ត・្・ត・ព・ល・ិ・ក
យកចិត្តទុកដាក់	យ・ក・ច・ិ・ត・្・ត・ទ・ុ・ក・ដ・ា・ក・់
អង្គរវត្ត	អ・ង・្・គ・រ・វ・ត・្・ត
ញាតិមិត្ត	ញ・ា・ត・ិ・ម・ិ・ត・្・ត
ព្រួយចិត្ត	ព・្・រ・ួ・យ・ច・ិ・ត・្・ត
ចិត្តសឿង	ច・ិ・ត・្・ត・ស・ឿ・ង
ព្រឹត្តិការ	ព・្・រ・ឹ・ត・្・ត・ិ・ក・ា・រ
សត្តនិករ	ស・ត・្・ត・ន・ិ・ក・រ
សុខចិត្ត	ស・ុ・ខ・ច・ិ・ត・្・ត
ប្រែចិត្ត	ប・្・រ・ែ・ច・ិ・ត・្・ត
ជ័យសម្បត្តិ	ជ・័・យ・ស・ម・្・ប・ត・្・ត・ិ
មិនសុខចិត្ត	ម・ិ・ន・ស・ុ・ខ・ច・ិ・ត・្・ត
សហប្រតិបត្តិ	ស・ហ・ប・្・រ・ត・ិ・ប・ត・្・ត・ិ
ដាច់ចិត្ត	ដ・ា・ច・់・ច・ិ・ត・្・ត
សេនារាជឧត្តម	ស・េ・ន・ា・រ・ា・ជ・ឧ・ត・្・ត・ម
ទេវទត្ត	ទ・េ・វ・ទ・ត・្・ត
ចូលនិវត្តន៍	ច・ូ・ល・ន・ិ・វ・ត・្・ត・ន・៍
អាណាខេត្ត	អ・ា・ណ・ា・ខ・េ・ត・្・ត
គ្រាកចិត្ត	គ・្・រ・ា・ក・ច・ិ・ត・្・ត
គតិយុត្ត	គ・ត・ិ・យ・ុ・ត・្・ត
ការវិវត្តន៍	ក・ា・រ・វ・ិ・វ・ត・្・ត・ន・៍
កែវឧត្តម	ក・ែ・វ・ឧ・ត・្・ត・ម
កម្សាន្តចិត្ត	ក・ម・្・ស・ា・ន・្・ត・ច・ិ・ត・្・ត
កាលានុវត្តនភាព	ក・ា・ល・ា・ន・ុ・វ・ត・្・ត・ន・ភ・ា・ព
កាលានុវត្ត	ក・ា・ល・ា・ន・ុ・វ・ត・្・ត
អស់ពីចិត្ត	អ・ស・់・ព・ី・ច・ិ・ត・្・ត
ប្រព្រឹត្តិការណ៍	ប・្・រ・ព・្・រ・ឹ・ត・្・ត・ិ・ក・ា・រ・ណ・៍
នក្ខត្តឫក្ស	ន・ក・្・ខ・ត・្・ត・ឫ・ក・្・ស
បំពេញចិត្ត	ប・ំ・ព・េ・ញ・ច・ិ・ត・្・ត
ក្បត់ចិត្ត	ក・្・ប・ត・់・ច・ិ・ត・្・ត
ឆ័ត្ត	ឆ・័・ត・្・ត
សញ្ញាប័ត្រកិត្តិយស	ស・ញ・្・ញ・ា・ប・័・ត・្・រ・ក・ិ・ត・្・ត・ិ・យ・ស
បរិត្ត	ប・រ・ិ・ត・្・ត
និមិត្តហេតុ	ន・ិ・ម・ិ・ត・្・ត・ហ・េ・ត・ុ
ចិត្តតូច	ច・ិ・ត・្・ត・ត・ូ・ច
ស្តុកសម្បត្តិ	ស・្・ត・ុ・ក・ស・ម・្・ប・ត・្・ត・ិ
ជឿចិត្ត	ជ・ឿ・ច・ិ・ត・្・ត
ផ្លូវចិត្ត	ផ・្・ល・ូ・វ・ច・ិ・ត・្・ត
វិមុត្ត	វ・ិ・ម・ុ・ត・្・ត
ចិត្តអំណត់	ច・ិ・ត・្・ត・អ・ំ・ណ・ត・់
អវត្តមាន	អ・វ・ត・្・ត・ម・ា・ន
ពីចិត្ត	ព・ី・ច・ិ・ត・្・ត
ព្រឹត្តិ	ព・្・រ・ឹ・ត・្・ត・ិ
ភោគសម្បត្តិ	ភ・ោ・គ・ស・ម・្・ប・ត・្・ត・ិ
ឯកត្តភាព	ឯ・ក・ត・្・ត・ភ・ា・ព
ចាំចិត្ត	ច・ា・ំ・ច・ិ・ត・្・ត
មានចិត្តចង់	ម・ា・ន・ច・ិ・ត・្・ត・ច・ង・់
សំរេចចិត្ត	ស・ំ・រ・េ・ច・ច・ិ・ត・្・ត
ខ្លឹមចិត្ត	ខ・្・ល・ឹ・ម・ច・ិ・ត・្・ត
ចិត្តត្រេកអរ	ច・ិ・ត・្・ត・ត・្・រ・េ・ក・អ・រ
រតនសម្បត្តិ	រ・ត・ន・ស・ម・្・ប・ត・្・ត・ិ
សម្ពន្ធមិត្ត	ស・ម・្・ព・ន・្・ធ・ម・ិ・ត・្・ត
អត់ចិត្ត	អ・ត・់・ច・ិ・ត・្・ត
វត្តលៀប	វ・ត・្・ត・ល・ៀ・ប
រត្តិចរ	រ・ត・្・ត・ិ・ច・រ
ក្តីមេត្តា	ក・្・ត・ី・ម・េ・ត・្・ត・ា
វត្តចាស់	វ・ត・្・ត・ច・ា・ស・់
សុំចិត្ត	ស・ុ・ំ・ច・ិ・ត・្・ត
ទាក់ចិត្ត	ទ・ា・ក・់・ច・ិ・ត・្・ត
អរហត្ត	អ・រ・ហ・ត・្・ត
រន្ធត់ចិត្ត	រ・ន・្・ធ・ត・់・ច・ិ・ត・្・ត
ស្វាយឧត្តម	ស・្・វ・ា・យ・ឧ・ត・្・ត・ម
ការប្រព្រឹត្តិ	ក・ា・រ・ប・្・រ・ព・្・រ・ឹ・ត・្・ត・ិ
សុបិននិមិត្ត	ស・ុ・ប・ិ・ន・ន・ិ・ម・ិ・ត・្・ត
ព្រះកិត្តិយស	ព・្・រ・ះ・ក・ិ・ត・្・ត・ិ・យ・ស
ចិត្តតិច	ច・ិ・ត・្・ត・ត・ិ・ច
កម្លាំងចិត្ត	ក・ម・្・ល・ា・ំ・ង・ច・ិ・ត・្・ត
សុចិត្តា	ស・ុ・ច・ិ・ត・្・ត・ា
ក្រោយវត្ត	ក・្・រ・ោ・យ・វ・ត・្・ត
បើកចិត្ត	ប・ើ・ក・ច・ិ・ត・្・ត
សេរីភ័ត្ត	ស・េ・រ・ី・ភ・័・ត・្・ត
ស្វ័យប្រវត្តិកម្ម	ស・្・វ・័・យ・ប・្・រ・វ・ត・្・ត・ិ・ក・ម・្・ម
មានចិត្ត	ម・ា・ន・ច・ិ・ត・្・ត
ការសំរេចចិត្ត	ក・ា・រ・ស・ំ・រ・េ・ច・ច・ិ・ត・្・ត
ក្បាលចិត្ត	ក・្・ប・ា・ល・ច・ិ・ត・្・ត
វរមិត្ត	វ・រ・ម・ិ・ត・្・ត
មានវិបត្តិ	ម・ា・ន・វ・ិ・ប・ត・្・ត・ិ
សម្បត្តិគុណ	ស・ម・្・ប・ត・្・ត・ិ・គ・ុ・ណ
មេត្តាករុណា	ម・េ・ត・្・ត・ា・ក・រ・ុ・ណ・ា
អត្តនោម័តិ	អ・ត・្・ត・ន・ោ・ម・័・ត・ិ
សម្រេចចិត្ត	ស・ម・្・រ・េ・ច・ច・ិ・ត・្・ត
ចិត្តជ្រះថ្លា	ច・ិ・ត・្・ត・ជ・្・រ・ះ・ថ・្・ល・ា
មិត្តរួមជាតិ	ម・ិ・ត・្・ត・រ・ួ・ម・ជ・ា・ត・ិ
ឧត្តរិភង្គ	ឧ・ត・្・ត・រ・ិ・ភ・ង・្・គ
សុទ្ធចិត្ត	ស・ុ・ទ・្・ធ・ច・ិ・ត・្・ត
ដឹងចិត្ត	ដ・ឹ・ង・ច・ិ・ត・្・ត
សម្បត្តិទ្រព្យ	ស・ម・្・ប・ត・្・ត・ិ・ទ・្・រ・ព・្・យ
សាលាខេត្ត	ស・ា・ល・ា・ខ・េ・ត・្・ត
មានចិត្តល្អ	ម・ា・ន・ច・ិ・ត・្・ត・ល・្・អ
ឯអត្តចរិត	ឯ・អ・ត・្・ត・ច・រ・ិ・ត
រាជសម្បត្តិ	រ・ា・ជ・ស・ម・្・ប・ត・្・ត・ិ
អាណត្ត	អ・ា・ណ・ត・្・ត
បំបាក់ទឹកចិត្ត	ប・ំ・ប・ា・ក・់・ទ・ឹ・ក・ច・ិ・ត・្・ត
ខត្តិយ	ខ・ត・្・ត・ិ・យ
ខូចចិត្ត	ខ・ូ・ច・ច・ិ・ត・្・ត
ជីវប្រវត្តិ	ជ・ី・វ・ប・្・រ・វ・ត・្・ត・ិ
បញ្ញត្តិ	ប・ញ・្・ញ・ត・្・ត・ិ
ទីរួមខេត្ត	ទ・ី・រ・ួ・ម・ខ・េ・ត・្・ត
សម្បត្តិ	ស・ម・្・ប・ត・្・ត・ិ
ឧត្តមសេនីយ	ឧ・ត・្・ត・ម・ស・េ・ន・ី・យ
ពោធិមិត្ត	ព・ោ・ធ・ិ・ម・ិ・ត・្・ត
វត្តសេដ្ឋី	វ・ត・្・ត・ស・េ・ដ・្・ឋ・ី
តាំងចិត្ត	ត・ា・ំ・ង・ច・ិ・ត・្・ត
